payload_key	effect_bundle_key
#cdir_events_payloads_tables;0;db/cdir_events_payloads_tables/cdir_events_payloads	
3c_Faction_Leader_Aurelian_Generic	3c_faction_leader_aurelian_generic
3c_Faction_Leader_Aurelian_outro	3c_Faction_Leader_Aurelian_outro
3c_Faction_Leader_Authority	3c_Faction_Leader_Authority
3c_Faction_Leader_Bonus	3c_Faction_Leader_Bonus
3c_Faction_Leader_Cannabaudes_Outro	3c_Faction_Leaders_Cannabaudes_Outro
3c_Faction_Leader_Cunning	3c_Faction_Leader_Cunning
3c_Faction_Leader_Hormizd_Outro	3c_Faction_Leaders_Hormizd_Outro
3c_Faction_Leader_Tetricus_outro	3c_Faction_Leader_Tetricus_outro
3c_Faction_Leader_Zeal	3c_Faction_Leader_Zeal
3c_alani_smoke_visions_i_A	3c_gothi_casting_the_lots_i_A
3c_alani_smoke_visions_i_B	3c_gothi_casting_the_lots_i_B
3c_alani_smoke_visions_i_C	3c_gothi_casting_the_lots_i_C
3c_alani_smoke_visions_i_D	3c_gothi_casting_the_lots_i_D
3c_betrayal_reduced_morale	3c_betrayal_reduced_morale
3c_betrayal_reduced_research	3c_betrayal_reduced_research
3c_betrayal_reduced_trade	3c_betrayal_reduced_trade
3c_caledoni_druidic_order_i_A	3c_gothi_casting_the_lots_i_A
3c_caledoni_druidic_order_i_B	3c_gothi_casting_the_lots_i_B
3c_caledoni_druidic_order_i_C	3c_gothi_casting_the_lots_i_C
3c_caledoni_druidic_order_i_D	3c_gothi_casting_the_lots_i_D
3c_cult_christianity_christmas	3c_cult_christianity_christmas
3c_cult_christianity_easter	3c_cult_christianity_easter
3c_cult_existing_manichaeism	3c_cult_manichaeism
3c_cult_existing_mithraism	3c_cult_mithraism
3c_cult_existing_sol_invictus	3c_cult_sol_invictus
3c_east_ardashir_testament_i_A	3c_east_ardashir_testament_i_A
3c_east_ardashir_testament_i_B	3c_east_ardashir_testament_i_B
3c_east_ardashir_testament_i_C	3c_east_ardashir_testament_i_C
3c_east_ardashir_testament_i_D	3c_east_ardashir_testament_i_D
3c_east_magi_council_i_A	3c_east_magi_council_i_A
3c_east_magi_council_i_B	3c_east_magi_council_i_B
3c_east_magi_council_i_C	3c_east_magi_council_i_C
3c_east_magi_council_i_D	3c_east_magi_council_i_D
3c_east_sassanian_sculptor_i_A	3c_east_sassanian_sculptor_i_A
3c_east_sassanian_sculptor_i_B	3c_east_sassanian_sculptor_i_B
3c_east_sassanian_sculptor_i_D	3c_east_sassanian_sculptor_i_D
3c_famous_bard	3c_famous_bard
3c_famous_scholar	3c_famous_scholar
3c_gothi_casting_the_lots_i_A	3c_gothi_casting_the_lots_i_A
3c_gothi_casting_the_lots_i_B	3c_gothi_casting_the_lots_i_B
3c_gothi_casting_the_lots_i_C	3c_gothi_casting_the_lots_i_C
3c_gothi_casting_the_lots_i_D	3c_gothi_casting_the_lots_i_D
3c_master_horseman	3c_master_horseman
3c_mystic_dreams_i_A_recruitment	3c_mystic_dreams_i_A_recruitment
3c_mystic_dreams_i_B_political	3c_mystic_dreams_i_B_political
3c_mystic_dreams_i_C_morale	3c_mystic_dreams_i_C_morale
3c_mystic_dreams_i_D_general_stats	3c_mystic_dreams_i_D_general_stats
3c_pax_romana	3c_pax_romana
3c_rat_infestation	3c_rat_infestation
3c_rat_infestation_D	3c_rat_infestation_D
3c_rat_infestation_i_A	3c_rat_infestation_i_A
3c_rat_infestation_i_B	3c_rat_infestation_i_B
3c_rat_infestation_i_C	3c_rat_infestation_i_C
3c_rat_infestation_i_D	3c_rat_infestation_i_D
3c_revolt_of_the_mint_workers	3c_revolt_of_the_mint_workers
3c_rom_Sibylline_Books_Agree_A1	3c_rom_Sibylline_Books_Agree_A1
3c_rom_Sibylline_Books_Agree_A2	3c_rom_Sibylline_Books_Agree_A2
3c_rom_Sibylline_Books_Agree_A3	3c_rom_Sibylline_Books_Agree_A3
3c_rom_Sibylline_Books_Agree_B1	3c_rom_Sibylline_Books_Agree_B1
3c_rom_Sibylline_Books_Agree_B2	3c_rom_Sibylline_Books_Agree_B2
3c_rom_Sibylline_Books_Agree_B3	3c_rom_Sibylline_Books_Agree_B3
3c_rom_Sibylline_Books_Agree_C1	3c_rom_Sibylline_Books_Agree_C1
3c_rom_Sibylline_Books_Agree_C2	3c_rom_Sibylline_Books_Agree_C2
3c_rom_Sibylline_Books_Agree_C3	3c_rom_Sibylline_Books_Agree_C3
3c_rom_Sibylline_Books_Agree_D1	3c_rom_Sibylline_Books_Agree_D1
3c_rom_Sibylline_Books_Agree_D2	3c_rom_Sibylline_Books_Agree_D2
3c_rom_Sibylline_Books_Agree_D3	3c_rom_Sibylline_Books_Agree_D3
3c_rom_Sibylline_Books_Burn	3c_rom_Sibylline_Books_Burn
3c_rom_Sibylline_Books_For_Show	3c_rom_Sibylline_Books_For_Show
3c_rom_Sibylline_Books_Hide	3c_rom_Sibylline_Books_Hide
3c_ships_at_the_port_A	3c_ships_at_the_port_A
3c_ships_at_the_port_B	3c_ships_at_the_port_B
3c_ships_at_the_port_C	3c_ships_at_the_port_C
3c_ships_at_the_port_D	3c_ships_at_the_port_D
3c_spring	3c_spring
3c_squalor_incident	3c_squalor_incident
3c_stolen_eagle	3c_stolen_eagle
3c_stolen_eagle_A	3c_stolen_eagle_A
3c_stolen_eagle_i_A	3c_stolen_eagle_i_A
3c_stolen_eagle_i_C	3c_stolen_eagle_i_C
3c_stolen_eagle_i_D	3c_stolen_eagle_i_D
3c_tactician	3c_tactician
BUILDING_LEVEL_RESTRICTION	
CHANGE_AMBITION	
CHANGE_AUTHORITY	
CHANGE_GRAVITAS	
CHANGE_PARTY_LOYALTY	
CHANGE_POLITICAL_POWER	
CHANGE_SUBTERFUGE	
CHANGE_ZEAL	
CHARACTER_UNAVAILABLE	
CLAN_FAME	
DAMAGE_BUILDING	
DEFECTION	
DEMOLISH_BUILDING_CHAIN	
DIPLOMATIC_STANDING	
GIVE_ANCILLARY	
GIVE_TECHNOLOGY	
GIVE_TRAIT	
HONOUR	
IMPRISON_CHARACTER	
Inv_loyalty_decr	Inv_loyalty_decr
Inv_loyalty_incr	Inv_loyalty_incr
KILL_CHARACTER	
LOYALTY	
MOVIE_EVENT	
PERSIST_VALUE	
PROMOTE_CHARACTER	
REBELLION	
SET_CAPITAL	
SPAWN_AGENT	
SPAWN_FORCE	
SPAWN_UNIT	
TARGET	
TOWN_WEALTH	
TRANSFER_REGION	
TREASURY	
UNLOCK_STATE_RELIGION_CHANGE	
WOUND_CHARACTER	
construction_costs_all_10_minus	construction_costs_all_10_minus
construction_costs_all_10_plus	construction_costs_all_10_plus
cultural_conversion_10_plus	cultural_conversion_10_plus
dk_architects_A	dk_architects_A
dk_architects_B	dk_architects_B
dk_architects_C	dk_architects_C
dk_camel_decease_A	dk_camel_disease_A
dk_camel_decease_B	dk_camel_disease_C
dk_camel_decease_C	dk_camel_disease_B
dk_construction_delayed_A	dk_construction_delayed_A
dk_construction_delayed_B	dk_construction_delayed_B
dk_dig_A1	dk_dig_A1
dk_dig_A2	dk_dig_A2
dk_dig_B	dk_dig_B
dk_dyes_A	dk_dyes_A
dk_dyes_B	dk_dyes_B
dk_dyes_C	dk_dyes_C
dk_fish_catch_A	dk_fish_catch_A
dk_fish_catch_B	dk_fish_catch_B
dk_fish_catch_C	dk_fish_catch_C
dk_foreign_intrigue_B	dk_foreign_intrigue_B
dk_foreign_intrigue_D	dk_foreign_intrigue_D
dk_foreign_ship_A	dk_foreign_ship_A
dk_gift_B	dk_gift_B
dk_gift_C	dk_gift_C
dk_gift_D	dk_gift_D
dk_glorious_past_A	dk_glorious_past_A
dk_glorious_past_B	dk_glorious_past_B
dk_glorious_past_C	dk_glorious_past_C
dk_gods_Amun	dk_gods_Amun
dk_gods_Apademak	dk_gods_Apademak
dk_gods_Arensnuphis	dk_gods_Arensnuphis
dk_gods_Horus	dk_gods_Horus
dk_gods_Isis	dk_gods_Isis
dk_gods_Khontu	dk_gods_Khonsu
dk_gods_Maat	dk_gods_Maat
dk_gods_Osiris	dk_gods_Osiris
dk_gods_Sebiumeker	dk_gods_Sebiumeker
dk_gods_Seth	dk_gods_Seth
dk_gods_Thoth	dk_gods_Thoth
dk_kush_nile_A_draught	dk_kush_nile_A_draught
dk_kush_nile_A_flood	dk_kush_nile_A_flood
dk_kush_nile_B_draught	dk_kush_nile_B_draught
dk_kush_nile_B_flood	dk_kush_nile_B_flood
dk_kush_priests_suicide_A	dk_kush_priests_suicide_A
dk_kush_priests_suicide_B	dk_kush_priests_suicide_B
dk_kush_pyramid_noble_A	dk_kush_pyramid_noble_A
dk_kush_pyramid_noble_B	dk_kush_pyramid_noble_B
dk_kush_pyramid_noble_C	dk_kush_pyramid_noble_C
dk_kush_pyramid_warrior_A	dk_kush_pyramid_warrior_A
dk_kush_pyramid_warrior_B	dk_kush_pyramid_warrior_B
dk_kush_pyramid_warrior_C	dk_kush_pyramid_warrior_C
dk_locusts_A	dk_locusts_A
dk_locusts_B	dk_locusts_B
dk_lost_caravan_fail	dk_lost_caravan_fail
dk_lost_caravan_success	dk_lost_caravan_success
dk_mercernaries_i	dk_mercernaries_i
dk_merchants_plea_B	dk_merchants_plea_B
dk_merchants_plea_C	dk_merchants_plea_C
dk_monster_i_A	dk_monster_A
dk_monster_i_B	dk_monster_B
dk_monster_i_C	dk_monster_C
dk_monster_i_D	dk_monster_D
dk_numidia_migration_A	dk_numidia_migration_A
dk_numidia_migration_B	dk_numidia_migration_B
dk_numidia_migration_C	dk_numidia_migration_C
dk_numidia_migration_D	dk_numidia_migration_D
dk_numidia_raid_A1	dk_numidia_raid_A1
dk_numidia_raid_A2	dk_numidia_raid_A2
dk_numidia_raid_B1	dk_numidia_raid_B1
dk_numidia_raid_B2	dk_numidia_raid_B2
dk_numidia_tribute_carthage	dk_numidia_tribute_carthage
dk_numidia_tribute_rome	dk_numidia_tribute_rome
dk_prosperity_A	dk_prosperity_A
dk_prosperity_B	dk_prosperity_B
dk_prosperity_C	dk_prosperity_C
dk_prosperity_D	dk_prosperity_D
dk_refugees_A	dk_refugees_A
dk_refugees_B	dk_refugees_B
dk_sand_storm_A	dk_sand_storm_A
dk_shipwreck_B	dk_shipwreck_B
dk_shipwreck_C	dk_shipwreck_C
dk_slavers_ship_A	dk_slavers_ship_A
dk_slavers_ship_B	dk_slavers_ship_B
dk_slavers_ship_C	dk_slavers_ship_C
dk_survivors_A	dk_survivors_A
dk_survivors_B	dk_survivors_B
dk_survivors_i_A	dk_survivors_i_A
dk_survivors_i_B	dk_survivors_i_B
dk_survivors_i_D	dk_survivors_i_D
dk_suspicious_merchant_A1	dk_suspicious_merchant_A1
dk_suspicious_merchant_A2	dk_suspicious_merchant_A2
dk_suspicious_merchant_B	dk_suspicious_merchant_B
dk_tools_A	dk_tools_A
dk_tools_B	dk_tools_B
dk_unhappy_workers_A	dk_unhappy_workers_A
dk_unhappy_workers_B	dk_unhappy_workers_B
female_leader_agriculture_barb_refuse	female_leader_agriculture_rom_refuse
female_leader_agriculture_desert_refuse	female_leader_agriculture_rom_refuse
female_leader_agriculture_east_refuse	female_leader_agriculture_rom_refuse
female_leader_agriculture_greek_refuse	female_leader_agriculture_rom_refuse
female_leader_agriculture_rom_refuse	female_leader_agriculture_rom_refuse
female_leader_cavalry_barb_refuse	female_leader_cavalry_barb_refuse
female_leader_cavalry_desert_refuse	female_leader_cavalry_barb_refuse
female_leader_cavalry_egypt_refuse	female_leader_cavalry_barb_refuse
female_leader_daughter_barb_refuse	female_leader_daughter_rom_refuse
female_leader_daughter_desert_refuse	female_leader_daughter_rom_refuse
female_leader_daughter_east_refuse	female_leader_daughter_rom_refuse
female_leader_daughter_greek_refuse	female_leader_daughter_rom_refuse
female_leader_daughter_rom_refuse	female_leader_daughter_rom_refuse
female_leader_diplomat_barb_refuse	female_leader_diplomat_rom_refuse
female_leader_diplomat_desert_refuse	female_leader_diplomat_rom_refuse
female_leader_diplomat_east_refuse	female_leader_diplomat_rom_refuse
female_leader_diplomat_greek_refuse	female_leader_diplomat_rom_refuse
female_leader_diplomat_rom_refuse	female_leader_diplomat_rom_refuse
female_leader_fleet_barb_refuse	female_leader_fleet_barb_refuse
female_leader_fleet_desert_refuse	female_leader_fleet_barb_refuse
female_leader_fleet_egypt_refuse	female_leader_fleet_barb_refuse
female_leader_scholar_barb_refuse	female_leader_scholar_rom_refuse
female_leader_scholar_desert_refuse	female_leader_scholar_rom_refuse
female_leader_scholar_east_refuse	female_leader_scholar_rom_refuse
female_leader_scholar_greek_refuse	female_leader_scholar_rom_refuse
female_leader_scholar_rom_refuse	female_leader_scholar_rom_refuse
female_leader_trader_barb_refuse	female_leader_trader_rom_refuse
female_leader_trader_desert_refuse	female_leader_trader_rom_refuse
female_leader_trader_east_refuse	female_leader_trader_rom_refuse
female_leader_trader_greek_refuse	female_leader_trader_rom_refuse
female_leader_trader_rom_refuse	female_leader_trader_rom_refuse
female_leader_warrior_barb_refuse	female_leader_warrior_barb_refuse
female_leader_warrior_desert_refuse	female_leader_warrior_barb_refuse
female_leader_warrior_egypt_refuse	female_leader_warrior_barb_refuse
festival_lemuria	festival_lemuria
festival_ludi_plebeii	festival_ludi_plebeii
festival_ludi_romani	festival_ludi_romani
festive_delphi	festive_delphi
festive_eleusis	festive_eleusis
festive_feast	festive_feast
festive_fire	festive_fire
festive_thesmophoria	festive_thesmophoria
festive_votive_offering	festive_votive_offering
festive_waters	festive_waters
honouring_the_god_of_sea	honouring_the_god_of_sea
imv_wealth_entertainment_incr	imv_wealth_entertainment_incr
inv_campaign_move_armies_incr	inv_campaign_move_armies_incr
inv_campaign_move_navies_incr	inv_campaign_move_navies_incr
inv_cavalry_charge_incr	inv_cavalry_charge_incr
inv_colony_discovered_1	inv_colony_discovered_1
inv_colony_discovered_2	inv_colony_discovered_2
inv_colony_discovered_3	inv_colony_discovered_3
inv_colony_discovered_4	inv_colony_discovered_4
inv_colony_discovered_5	inv_colony_discovered_5
inv_colony_discovered_fail_gods	inv_colony_discovered_fail_gods
inv_colony_discovered_fail_man	inv_colony_discovered_fail_man
inv_construction_cost_temple_decr	inv_construction_cost_temple_decr
inv_construction_cost_temple_incr	inv_construction_cost_temple_incr
inv_corruption_decr	inv_corruption_decr
inv_culture_celtic_incr	inv_culture_celtic_incr
inv_culture_greek_incr	inv_culture_greek_incr
inv_culture_own_incr	rom_payload_culture_suppression
inv_diplomacy_all_decr	inv_diplomacy_all_decr
inv_diplomacy_all_incr	inv_diplomacy_all_incr
inv_diplomacy_greek_incr	inv_diplomacy_greek_incr
inv_etruscan_summit_payload_1	inv_etruscan_summit_effect_bundle_1
inv_etruscan_summit_payload_2	inv_etruscan_summit_effect_bundle_2
inv_etruscan_summit_payload_3	inv_etruscan_summit_effect_bundle_3
inv_etruscan_summit_payload_4	inv_etruscan_summit_effect_bundle_4
inv_etruscan_summit_payload_5	inv_etruscan_summit_effect_bundle_5
inv_etruscan_summit_payload_6	inv_etruscan_summit_effect_bundle_6
inv_festival_cerealia_Rome_payload	inv_festival_cerealia_Rome_payload
inv_festival_cerealia_Samnites_payload	inv_festival_cerealia_Samnites_payload
inv_festival_great_dionysia_Syracuse_payload	inv_festival_great_dionysia_Syracuse_payload
inv_festival_great_dionysia_Taranto_payload	inv_festival_great_dionysia_Taranto_payload
inv_festival_rural_dionysia_Samnites_payload	inv_festival_rural_dionysia_Samnites_payload
inv_festival_rural_dionysia_Veneti_payload	inv_festival_rural_dionysia_Veneti_payload
inv_festival_vinalia_rustica_payload	inv_festival_vinalia_rustica_payload
inv_geographical_carthage_1_A	inv_geographical_carthage_1_A
inv_geographical_carthage_1_B	inv_geographical_carthage_1_B
inv_geographical_carthage_2_A	inv_geographical_carthage_2_A
inv_geographical_carthage_2_B	inv_geographical_carthage_2_B
inv_geographical_carthage_2_C	inv_geographical_carthage_2_C
inv_geographical_carthage_3_A	inv_geographical_carthage_3_A
inv_geographical_carthage_3_B	inv_geographical_carthage_3_B
inv_geographical_carthage_4_A	inv_geographical_carthage_4_A
inv_geographical_carthage_4_B	inv_geographical_carthage_4_B
inv_geographical_carthage_5_A	inv_geographical_carthage_5_A
inv_geographical_carthage_5_B	inv_geographical_carthage_5_B
inv_greek_philosophers_incident_1	inv_greek_philosophers_incident_1
inv_greek_philosophers_incident_2	inv_greek_philosophers_incident_2
inv_greek_philosophers_incident_3	inv_greek_philosophers_incident_3
inv_greek_philosophers_incident_4	inv_greek_philosophers_incident_4
inv_greek_philosophers_incident_5	inv_greek_philosophers_incident_5
inv_greek_philosophers_incident_6	inv_greek_philosophers_incident_6
inv_growth_decr	inv_growth_decr
inv_growth_incr	inv_growth_incr
inv_homefront_01_A	inv_homefront_01_A
inv_homefront_01_B	inv_homefront_01_B
inv_homefront_01_C	inv_homefront_01_C
inv_homefront_02_A	inv_homefront_02_A
inv_homefront_02_B	inv_homefront_02_B
inv_homefront_02_C	inv_homefront_02_C
inv_homefront_03_A	inv_homefront_03_A
inv_homefront_03_B	inv_homefront_03_B
inv_homefront_03_C	inv_homefront_03_C
inv_homefront_04_A	inv_homefront_04_A
inv_homefront_04_B	inv_homefront_04_B
inv_homefront_04_C	inv_homefront_04_C
inv_homefront_05_A	inv_homefront_05_A
inv_homefront_05_B	inv_homefront_05_B
inv_homefront_05_C	inv_homefront_05_C
inv_homefront_06_A	inv_homefront_06_A
inv_homefront_06_B	inv_homefront_06_B
inv_homefront_06_C	inv_homefront_06_C
inv_homefront_07_A	inv_homefront_07_A
inv_homefront_07_B	inv_homefront_07_B
inv_homefront_07_C	inv_homefront_07_C
inv_homefront_08_A	inv_homefront_08_A
inv_homefront_08_B	inv_homefront_08_B
inv_homefront_08_C	inv_homefront_08_C
inv_homefront_09_A	inv_homefront_09_A
inv_homefront_09_B	inv_homefront_09_B
inv_homefront_09_C	inv_homefront_09_C
inv_homefront_10_A	inv_homefront_10_A
inv_homefront_10_B	inv_homefront_10_B
inv_homefront_10_C	inv_homefront_10_C
inv_homefront_11_A	inv_homefront_11_A
inv_homefront_11_B	inv_homefront_11_B
inv_homefront_11_C	inv_homefront_11_C
inv_homefront_12_A	inv_homefront_12_A
inv_homefront_12_B	inv_homefront_12_B
inv_homefront_12_C	inv_homefront_12_C
inv_homefront_win_athens	inv_homefront_win_athens
inv_homefront_win_coritnh	inv_homefront_win_corinth
inv_homefront_win_sparta	inv_homefront_win_sparta
inv_incident_payload_character_trait_dummy	inv_incident_payload_character_trait_dummy
inv_incident_payload_character_unavailable_dummy	inv_incident_payload_character_unavailable_dummy
inv_insubres_divine_will_clandestine	inv_insubres_divine_will_clandestine
inv_insubres_divine_will_divine	inv_insubres_divine_will_divine
inv_insubres_divine_will_holy	inv_insubres_divine_will_holy
inv_insubres_divine_will_outfit	inv_insubres_divine_will_outfit
inv_insubres_motivate_populace_agriculture	inv_insubres_motivate_populace_agriculture
inv_insubres_motivate_populace_bardic	inv_insubres_motivate_populace_bardic
inv_insubres_motivate_populace_brotherly	inv_insubres_motivate_populace_brotherly
inv_insubres_motivate_populace_civil	inv_insubres_motivate_populace_civil
inv_insubres_motivate_populace_failed	inv_insubres_motivate_populace_failed
inv_insubres_motivate_populace_tribal	inv_insubres_motivate_populace_tribal
inv_insubres_motivate_populace_war	inv_insubres_motivate_populace_war
inv_loot_incr	inv_sacking_incr
inv_massalia_civilians_sent	inv_massalia_civilians_sent
inv_massalia_cure_all_army_neg	inv_massalia_cure_all_army_neg
inv_massalia_cure_all_army_pos	inv_massalia_cure_all_army_pos
inv_massalia_cure_all_noblemen_neg	inv_massalia_cure_all_noblemen_neg
inv_massalia_cure_all_noblemen_pos	inv_massalia_cure_all_noblemen_pos
inv_massalia_cure_all_populace_neg	inv_massalia_cure_all_populace_neg
inv_massalia_cure_all_populace_pos	inv_massalia_cure_all_populace_pos
inv_massalia_engineers_sent	inv_massalia_engineers_sent
inv_massalia_jewelry	inv_massalia_jewelry
inv_massalia_local_profit	inv_massalia_local_profit
inv_massalia_maritime_trade	inv_massalia_sea_trade
inv_massalia_request_denied	inv_massalia_request_denied
inv_massalia_sea_trade	inv_massalia_sea_trade
inv_massalia_trade_rights	inv_massalia_trade_rights
inv_massalia_trade_rights_denied	inv_massalia_trade_rights_denied
inv_massalia_trade_rights_sabotaged	inv_massalia_trade_rights_sabotaged
inv_massalia_wine	inv_massalia_wine
inv_massalian_amber	inv_massalia_amber
inv_melee_damage_armies_Incr	inv_melee_damage_armies_Incr
inv_morale_armies_decr	inv_morale_armies_decr
inv_morale_armies_incr	inv_morale_armies_incr
inv_morale_navies_incr	inv_morale_navies_incr
inv_patricians_conniving	inv_patricians_conniving
inv_patricians_conspiring	inv_patricians_conspiring
inv_patricians_content	inv_patricians_content
inv_patricians_happy	inv_patricians_happy
inv_patricians_indifferent	inv_patricians_indifferent
inv_plebs_angry	inv_plebs_angry
inv_plebs_content	inv_plebs_content
inv_plebs_grumbling	inv_plebs_grumbling
inv_plebs_happy	inv_plebs_happy
inv_plebs_indifferent	inv_plebs_indifferent
inv_public_order_decr	inv_public_order_decr
inv_public_order_incr	inv_public_order_incr
inv_recruitment_cost_all_decr	inv_recruitment_cost_all_decr
inv_recruitment_cost_infantry_decr	inv_recruitment_cost_infantry_decr
inv_recruitment_cost_merc_decr	inv_recruitment_cost_merc_decr
inv_recruitment_slot_incr	inv_recruitment_slot_incr
inv_replenishment_incr	inv_replenishment_incr
inv_research_decr	inv_research_decr
inv_research_incr	inv_research_incr
inv_samnites_ver_sacrum	inv_samnites_ver_sacrum
inv_senones_divination_ambush	inv_senones_divination_ambush
inv_senones_divination_assault	inv_senones_divination_assault
inv_senones_divination_attack	inv_senones_divination_attack
inv_senones_divination_defend	inv_senones_divination_defend
inv_senones_divination_invade	inv_senones_divination_invade
inv_senones_divination_night	inv_senones_divination_night
inv_senones_war_decree_celts	inv_senones_war_decree_celts
inv_senones_war_decree_etruscans	inv_senones_war_decree_etruscans
inv_senones_war_decree_greek	inv_senones_war_decree_greek
inv_senones_war_decree_italic	inv_senones_war_decree_italic
inv_senones_war_decree_nuragic	inv_senones_war_decree_nuragic
inv_senones_war_decree_romans	inv_senones_war_decree_romans
inv_slave_decr	inv_slave_decr
inv_slave_incr	inv_slave_incr
inv_taxes_decr	inv_taxes_decr
inv_upkeep_cost_armies_decr	inv_upkeep_cost_armies_decr
inv_veneti_breed_civil	inv_veneti_breed_civil
inv_veneti_breed_military	inv_veneti_breed_military
inv_wealth_agri_decr	inv_wealth_agri_decr
inv_wealth_agri_incr	inv_wealth_agri_incr
inv_wealth_commerce_local_decr	inv_wealth_commerce_local_decr
inv_wealth_commerce_local_incr	inv_wealth_commerce_local_incr
inv_wealth_industry_decr	inv_wealth_industry_decr
inv_wealth_industry_incr	inv_wealth_industry_incr
inv_wealth_learning_incr	inv_wealth_subsistence_incr
inv_wealth_tariffs_incr	inv_wealth_tariffs_incr
isthmian_celebratory	isthmian_celebratory
isthmian_successful	isthmian_successful
isthmian_unhappy	isthmian_unhappy
isthmian_unsuccessful	isthmian_unsuccessful
nemean_celebratory	nemean_celebratory
nemean_successful	nemean_successful
nemean_unhappy	nemean_unhappy
nemean_unsuccessful	nemean_unsuccessful
olympics_celebratory	olympics_celebratory
olympics_successful	olympics_successful
olympics_unhappy	olympics_unhappy
olympics_unsuccessful	olympics_unsuccessful
payload_banditry	payload_banditry
payload_cursed_leader	payload_cursed_leader
payload_great_peace	payload_great_peace
payload_growing_bureaucracy	payload_growing_bureaucracy
payload_ravaged_land	payload_ravaged_land
payload_slave_riots	payload_slave_riots
payload_slaves_escaped	payload_slaves_escaped
payload_trade_master	payload_trade_master
payload_warmongers	payload_warmongers
pel_festival_adonis	pel_festival_adonis
pel_festival_apollo	pel_festival_apollo
pel_festival_athena	pel_festival_athena
pel_festival_bronze_workers	pel_festival_bronze_workers
pel_festival_dionysos	pel_festival_dionysos
pel_festival_dionysos_athenai	pel_festival_dionysos_athenai
pel_festival_gods	pel_festival_gods
pel_festival_helen	pel_festival_helen
pel_festival_helots	pel_festival_helots
pel_festival_herakles	pel_festival_herakles
pel_festival_naked_youths	pel_festival_naked_youths
pel_festival_panathenaic_games	pel_festival_panathenaic_games
pel_festival_salamis	pel_festival_salamis
pel_festival_women	pel_festival_women
pel_festival_zeus	pel_festival_zeus
pel_plague_athens	pel_plague_athens
pythian_celebratory	pythian_celebratory
pythian_successful	pythian_successful
pythian_unhappy	pythian_unhappy
pythian_unsuccessful	pythian_unsuccessful
rom_payload_agent_champion_cost	rom_payload_agent_champion_cost
rom_payload_agent_champion_experience	rom_payload_agent_champion_experience
rom_payload_agent_champion_success	rom_payload_agent_champion_success
rom_payload_agent_dignitary_cost	rom_payload_agent_dignitary_cost
rom_payload_agent_dignitary_experience	rom_payload_agent_dignitary_experience
rom_payload_agent_dignitary_success	rom_payload_agent_dignitary_success
rom_payload_agent_spy_cost	rom_payload_agent_spy_cost
rom_payload_agent_spy_experience	rom_payload_agent_spy_experience
rom_payload_agent_spy_success	rom_payload_agent_spy_success
rom_payload_agrarian_purpose	rom_payload_agrarian_purpose
rom_payload_agriculture_gdp_mod_negative	rom_payload_agriculture_gdp_mod_negative
rom_payload_auxiliary_recruitment	rom_payload_auxiliary_recruitment
rom_payload_bread_circuses	rom_payload_bread_circuses
rom_payload_call_sea	rom_payload_call_sea
rom_payload_call_to_arms_global	rom_payload_call_to_arms_global
rom_payload_call_to_arms_local	rom_payload_call_to_arms_local
rom_payload_cavalry_command	rom_payload_cavalry_command
rom_payload_cavalry_recruitment	rom_payload_cavalry_recruitment
rom_payload_cavalry_training	rom_payload_cavalry_training
rom_payload_cultural_unrest	rom_payload_cultural_unrest
rom_payload_cultural_unrest_hellenic	rom_payload_cultural_unrest_hellenic
rom_payload_culture_integration	rom_payload_culture_integration
rom_payload_culture_suppression	rom_payload_culture_suppression
rom_payload_culture_understanding	rom_payload_culture_understanding
rom_payload_death_metal	rom_payload_death_metal
rom_payload_decline_global	rom_payload_decline_global
rom_payload_decline_local	rom_payload_decline_local
rom_payload_diplomatic_contempt	rom_payload_diplomatic_contempt
rom_payload_diplomatic_contempt_hellenic	rom_payload_diplomatic_contempt_hellenic
rom_payload_diplomatic_respect	rom_payload_diplomatic_respect
rom_payload_diplomatic_respect_hellenic	rom_payload_diplomatic_respect_hellenic
rom_payload_disaffection_global	rom_payload_disaffection_global
rom_payload_disaffection_local	rom_payload_disaffection_local
rom_payload_disaster_earthquake	rom_payload_disaster_earthquake
rom_payload_disaster_fire	rom_payload_disaster_fire
rom_payload_disaster_floods	rom_payload_disaster_floods
rom_payload_food	rom_payload_food
rom_payload_grateful_populace	rom_payload_grateful_populace
rom_payload_infantry_recruitment	rom_payload_infantry_recruitment
rom_payload_inspired_endeavours_global	rom_payload_inspired_endeavours_global
rom_payload_inspired_endeavours_local	rom_payload_inspired_endeavours_local
rom_payload_local_happiness	rom_payload_local_happiness
rom_payload_mercenary_compensation	rom_payload_mercenary_compensation
rom_payload_mercenary_contact	rom_payload_mercenary_contact
rom_payload_mercenary_negotiation	rom_payload_mercenary_negotiation
rom_payload_military_experience	rom_payload_military_experience
rom_payload_military_setback	rom_payload_military_setback
rom_payload_naval_recruitment	rom_payload_naval_recruitment
rom_payload_pirate_hunting	rom_payload_pirate_hunting
rom_payload_plague_army	rom_payload_plague_army
rom_payload_plague_settlement	rom_payload_plague_settlement
rom_payload_political_adoption_accepted	rom_political_dilemma_payload_adoption_accepted
rom_payload_precious	rom_payload_precious
rom_payload_prosperity_global	rom_payload_prosperity_global
rom_payload_prosperity_local	rom_payload_prosperity_local
rom_payload_public_works_global	rom_payload_public_works_global
rom_payload_public_works_local	rom_payload_public_works_local
rom_payload_rampant_piracy	rom_payload_rampant_piracy
rom_payload_raw_material	rom_payload_raw_material
rom_payload_religion_rom_jupiter_will	rom_payload_religion_rom_jupiter_will
rom_payload_religion_rom_mars_wrath	rom_payload_religion_rom_mars_wrath
rom_payload_religion_rom_mercury_way	rom_payload_religion_rom_mercury_way
rom_payload_religion_rom_vulcan_hammer	rom_payload_religion_rom_vulcan_hammer
rom_payload_research	rom_payload_research
rom_payload_research_civil_progress	rom_payload_research_civil_progress
rom_payload_research_martial_ambition	rom_payload_research_martial_ambition
rom_payload_research_thirst_for_knowledge	rom_payload_research_thirst_for_knowledge
rom_payload_resolution	rom_payload_resolution_dummy
rom_payload_servitude	rom_payload_servitude
rom_payload_setback_sandstorm	rom_payload_setback_sandstorm
rom_payload_setback_snowstorm	rom_payload_setback_snowstorm
rom_payload_siegecraft	rom_payload_siegecraft
rom_payload_slave_economic_negative	rom_payload_slave_economic_negative
rom_payload_slave_economic_positive	rom_payload_slave_economic_positive
rom_payload_slave_happiness	rom_payload_slave_happiness
rom_payload_slave_unhappiness	rom_payload_slave_unhappiness
rom_payload_slaves_decrease	rom_payload_slaves_decrease
rom_payload_slaves_increase	rom_payload_slaves_increase
rom_payload_subject_horse	rom_payload_subject_horse
rom_payload_subject_local_trade	rom_subject_local_trade
rom_payload_subject_research	rom_payload_subject_research
rom_payload_subject_slaver	rom_payload_subject_slaver
rom_payload_thriving_trade	rom_payload_thriving_trade
rom_payload_tribute	rom_payload_tribute
rom_payload_tribute_local	rom_payload_tribute_local
rom_payload_unhappy_populace	rom_payload_unhappy_populace
rom_payload_urban_migration_global	rom_payload_urban_migration_global
rom_payload_urban_migration_local	rom_payload_urban_migration_local
rom_payload_wait_and_see	rom_payload_wait_and_see
rom_payload_war_fervour	rom_payload_war_fervour
rom_payload_weapons	rom_payload_weapons
rom_subject_bad_omen	rom_subject_bad_omen
rom_subject_favoured_by_gods	rom_subject_favoured_by_gods
rom_subject_local_trade_negative	rom_subject_local_trade_negative
rom_subject_payload_aventine	rom_subject_payload_aventine
rom_subject_payload_foreign_trade	rom_subject_foreign_trade
rom_subject_payload_good_omen	rom_subject_good_omen
rom_subject_payload_nisean	rom_subject_payload_nisean
rom_subject_payload_purple	rom_subject_payload_purple
rom_subject_payload_spice	rom_subject_payload_spice
rom_subject_payload_wine	rom_subject_payload_wine
rom_subject_wrath_of_gods	rom_subject_wrath_of_gods
subject_culture_bad	subject_culture_bad
subject_culture_good	subject_culture_good
subject_diplomacy_bad	subject_diplomacy_bad
subject_diplomacy_good	subject_diplomacy_good
subject_gdp_bad	subject_gdp_bad
subject_gdp_good	subject_gdp_good
subject_happiness_bad	subject_happiness_bad
subject_happiness_good	subject_happiness_good
trait_gained	trait_gained
wealth_from_culture_25_plus	wealth_from_culture_25_plus
wealth_from_industry_25_minus	wealth_from_industry_25_minus
wealth_from_slaves_20_minus	wealth_from_slaves_20_minus
wealth_local_commerce_15_plus	wealth_local_commerce_15_plus
wealth_local_commerce_25_minus	wealth_local_commerce_25_minus
