key	subculture	for_army	campaign
#military_force_legacy_names_tables;2;db/military_force_legacy_names_tables/military_force_legacy_names			
3c_legacy_afro_arabian_allatu_heralds	sc_rom_african_arabian	true	main_3c
3c_legacy_afro_arabian_apedemak_pride	sc_rom_african_arabian	true	main_3c
3c_legacy_afro_arabian_beasts_burden	sc_rom_african_arabian	true	main_3c
3c_legacy_afro_arabian_bronze_warriors	sc_rom_african_arabian	true	main_3c
3c_legacy_afro_arabian_death_merchants	sc_rom_african_arabian	true	main_3c
3c_legacy_afro_arabian_desert_guardians	sc_rom_african_arabian	true	main_3c
3c_legacy_afro_arabian_desert_old_men	sc_rom_african_arabian	true	main_3c
3c_legacy_afro_arabian_desert_scorpions	sc_rom_african_arabian	true	main_3c
3c_legacy_afro_arabian_desert_snakes	sc_rom_african_arabian	true	main_3c
3c_legacy_afro_arabian_desert_wind	sc_rom_african_arabian	true	main_3c
3c_legacy_afro_arabian_gurzil_horns	sc_rom_african_arabian	true	main_3c
3c_legacy_afro_arabian_lords_war	sc_rom_african_arabian	true	main_3c
3c_legacy_afro_arabian_mahrem_sons	sc_rom_african_arabian	true	main_3c
3c_legacy_afro_arabian_nomads_dread	sc_rom_african_arabian	true	main_3c
3c_legacy_afro_arabian_sand_sentinels	sc_rom_african_arabian	true	main_3c
3c_legacy_afro_arabian_sands_burning	sc_rom_african_arabian	true	main_3c
3c_legacy_afro_arabian_stone_burners	sc_rom_african_arabian	true	main_3c
3c_legacy_afro_arabian_sun_children	sc_rom_african_arabian	true	main_3c
3c_legacy_afro_arabian_sun_warriors	sc_rom_african_arabian	true	main_3c
3c_legacy_afro_arabian_warriors_fortune	sc_rom_african_arabian	true	main_3c
3c_legacy_barb_east_agin_blades	sc_rom_barb_east	true	main_3c
3c_legacy_barb_east_api_defenders	sc_rom_barb_east	true	main_3c
3c_legacy_barb_east_battle_axes	sc_rom_barb_east	true	main_3c
3c_legacy_barb_east_blades_of_grass	sc_rom_barb_east	true	main_3c
3c_legacy_barb_east_blood_riders	sc_rom_barb_east	true	main_3c
3c_legacy_barb_east_bloodletters	sc_rom_barb_east	true	main_3c
3c_legacy_barb_east_drifters	sc_rom_barb_east	true	main_3c
3c_legacy_barb_east_gales_of_wind	sc_rom_barb_east	true	main_3c
3c_legacy_barb_east_golden_army	sc_rom_barb_east	true	main_3c
3c_legacy_barb_east_husbands_of_amazons	sc_rom_barb_east	true	main_3c
3c_legacy_barb_east_hyperboria	sc_rom_barb_east	true	main_3c
3c_legacy_barb_east_larch_children	sc_rom_barb_east	true	main_3c
3c_legacy_barb_east_nomads_dread	sc_rom_barb_east	true	main_3c
3c_legacy_barb_east_oitosyros_will	sc_rom_barb_east	true	main_3c
3c_legacy_barb_east_papaios_champions	sc_rom_barb_east	true	main_3c
3c_legacy_barb_east_poison_arrows	sc_rom_barb_east	true	main_3c
3c_legacy_barb_east_riders_rough	sc_rom_barb_east	true	main_3c
3c_legacy_barb_east_riders_swift	sc_rom_barb_east	true	main_3c
3c_legacy_barb_east_sacrificers	sc_rom_barb_east	true	main_3c
3c_legacy_barb_east_seekers_of_destiny	sc_rom_barb_east	true	main_3c
3c_legacy_barb_east_skulls_golden	sc_rom_barb_east	true	main_3c
3c_legacy_barb_east_steeds_doom	sc_rom_barb_east	true	main_3c
3c_legacy_barb_east_steppe_fury	sc_rom_barb_east	true	main_3c
3c_legacy_barb_east_steppe_scourge	sc_rom_barb_east	true	main_3c
3c_legacy_barb_east_steppe_storm	sc_rom_barb_east	true	main_3c
3c_legacy_barb_east_steppe_wanderers	sc_rom_barb_east	true	main_3c
3c_legacy_barb_east_steppe_wolves	sc_rom_barb_east	true	main_3c
3c_legacy_barb_east_strength_of_api	sc_rom_barb_east	true	main_3c
3c_legacy_barb_east_tabiti_flames	sc_rom_barb_east	true	main_3c
3c_legacy_barb_east_wayward_warriors	sc_rom_barb_east	true	main_3c
3c_legacy_barb_east_wild_ones	sc_rom_barb_east	true	main_3c
3c_legacy_briton_albion_champions	sc_rom_british	true	main_3c
3c_legacy_briton_andraste_will	sc_rom_british	true	main_3c
3c_legacy_briton_belatucadros_blades	sc_rom_british	true	main_3c
3c_legacy_briton_brutus_children	sc_rom_british	true	main_3c
3c_legacy_briton_burning_men	sc_rom_british	true	main_3c
3c_legacy_briton_camulos_horns	sc_rom_british	true	main_3c
3c_legacy_briton_cocidius_hunters	sc_rom_british	true	main_3c
3c_legacy_briton_ebraucus_vanquishers	sc_rom_british	true	main_3c
3c_legacy_briton_iron_fist	sc_rom_british	true	main_3c
3c_legacy_briton_mists_doom	sc_rom_british	true	main_3c
3c_legacy_briton_morrigan_consorts	sc_rom_british	true	main_3c
3c_legacy_briton_spear_runners	sc_rom_british	true	main_3c
3c_legacy_briton_stags_noble	sc_rom_british	true	main_3c
3c_legacy_briton_sword_power	sc_rom_british	true	main_3c
3c_legacy_briton_woad_warriors	sc_rom_british	true	main_3c
3c_legacy_celtic_mountain_men	sc_rom_british	true	main_3c
3c_legacy_celtic_spear_men	sc_rom_british	true	main_3c
3c_legacy_celtic_stone_crows	sc_rom_british	true	main_3c
3c_legacy_celtic_tumult	sc_rom_british	true	main_3c
3c_legacy_celtic_warmongers	sc_rom_british	true	main_3c
3c_legacy_celtic_warriors_wandering	sc_rom_british	true	main_3c
3c_legacy_eastern_army_immortals	sc_rom_eastern	true	main_3c
3c_legacy_eastern_bane_of_rome	sc_rom_eastern	true	main_3c
3c_legacy_eastern_brothers_arms	sc_rom_eastern	true	main_3c
3c_legacy_eastern_fire_steel	sc_rom_eastern	true	main_3c
3c_legacy_eastern_first_men	sc_rom_eastern	true	main_3c
3c_legacy_eastern_flames_pruifying	sc_rom_eastern	true	main_3c
3c_legacy_eastern_followers_of_shapur	sc_rom_eastern	true	main_3c
3c_legacy_eastern_forgotten_warriors	sc_rom_eastern	true	main_3c
3c_legacy_eastern_heroes_men	sc_rom_eastern	true	main_3c
3c_legacy_eastern_ishtar_champions	sc_rom_eastern	true	main_3c
3c_legacy_eastern_keepers_of_the_sacred_flame	sc_rom_eastern	true	main_3c
3c_legacy_eastern_light_bringers	sc_rom_eastern	true	main_3c
3c_legacy_eastern_manticore_claws	sc_rom_eastern	true	main_3c
3c_legacy_eastern_serpent_eyes	sc_rom_eastern	true	main_3c
3c_legacy_eastern_slayers_of_emperors	sc_rom_eastern	true	main_3c
3c_legacy_eastern_stone_cutters	sc_rom_eastern	true	main_3c
3c_legacy_eastern_truth_bearers	sc_rom_eastern	true	main_3c
3c_legacy_eastern_warriors_of_zoroaster	sc_rom_eastern	true	main_3c
3c_legacy_eastern_watchmen	sc_rom_eastern	true	main_3c
3c_legacy_eastern_watch	sc_rom_eastern	true	main_3c
3c_legacy_eastern_xerxes_scions	sc_rom_eastern	true	main_3c
3c_legacy_germanic_beholder_tuisto_skull	sc_rom_germanic	true	main_3c
3c_legacy_germanic_berserkers_dread	sc_rom_germanic	true	main_3c
3c_legacy_germanic_blood_embers	sc_rom_germanic	true	main_3c
3c_legacy_germanic_bloodaxes	sc_rom_germanic	true	main_3c
3c_legacy_germanic_bloodsworn	sc_rom_germanic	true	main_3c
3c_legacy_germanic_breakers_of_trees	sc_rom_germanic	true	main_3c
3c_legacy_germanic_brothers_metal	sc_rom_germanic	true	main_3c
3c_legacy_germanic_children_of_the_forest	sc_rom_germanic	true	main_3c
3c_legacy_germanic_doom_children	sc_rom_germanic	true	main_3c
3c_legacy_germanic_dragonslayers	sc_rom_germanic	true	main_3c
3c_legacy_germanic_einherjars	sc_rom_germanic	true	main_3c
3c_legacy_germanic_feeder_of_war_gull	sc_rom_germanic	true	main_3c
3c_legacy_germanic_feeders_of_eagle	sc_rom_germanic	true	main_3c
3c_legacy_germanic_fimmilena_victors	sc_rom_germanic	true	main_3c
3c_legacy_germanic_fires_sunna	sc_rom_germanic	true	main_3c
3c_legacy_germanic_friagabis_champions	sc_rom_germanic	true	main_3c
3c_legacy_germanic_frijjo_consorts	sc_rom_germanic	true	main_3c
3c_legacy_germanic_heralds_of_hymir	sc_rom_germanic	true	main_3c
3c_legacy_germanic_howling_wolves	sc_rom_germanic	true	main_3c
3c_legacy_germanic_icicles_of_blood	sc_rom_germanic	true	main_3c
3c_legacy_germanic_jotun_slayers	sc_rom_germanic	true	main_3c
3c_legacy_germanic_lightning_riders	sc_rom_germanic	true	main_3c
3c_legacy_germanic_men_of_war	sc_rom_germanic	true	main_3c
3c_legacy_germanic_minions_of_wolf_father	sc_rom_germanic	true	main_3c
3c_legacy_germanic_oak_children	sc_rom_germanic	true	main_3c
3c_legacy_germanic_oath_maker	sc_rom_germanic	true	main_3c
3c_legacy_germanic_raging_boars	sc_rom_germanic	true	main_3c
3c_legacy_germanic_skull_breaker	sc_rom_germanic	true	main_3c
3c_legacy_germanic_sons_of_bears	sc_rom_germanic	true	main_3c
3c_legacy_germanic_sons_of_gaut	sc_rom_germanic	true	main_3c
3c_legacy_germanic_swans_of_blood	sc_rom_germanic	true	main_3c
3c_legacy_germanic_thryms_chosen	sc_rom_germanic	true	main_3c
3c_legacy_germanic_thunaraz_hammer	sc_rom_germanic	true	main_3c
3c_legacy_germanic_thunaraz_thunderbolts	sc_rom_germanic	true	main_3c
3c_legacy_germanic_trees_woe	sc_rom_germanic	true	main_3c
3c_legacy_germanic_warrior_skalds	sc_rom_germanic	true	main_3c
3c_legacy_germanic_wild_hunters	sc_rom_germanic	true	main_3c
3c_legacy_germanic_wodanaz_host	sc_rom_germanic	true	main_3c
3c_legacy_germanic_wolves_war	sc_rom_germanic	true	main_3c
3c_legacy_germanic_wooden_men	sc_rom_germanic	true	main_3c
3c_legacy_navy_afro_arabian_sea_scourge	sc_rom_african_arabian	false	main_3c
3c_legacy_navy_amber_warrior	sc_rom_germanic	false	main_3c
3c_legacy_navy_atargatis_champions	sc_rom_eastern	false	main_3c
3c_legacy_navy_barb_east_agrimpasa_pride	sc_rom_barb_east	false	main_3c
3c_legacy_navy_barb_east_black_waters	sc_rom_barb_east	false	main_3c
3c_legacy_navy_barb_east_dark_tides	sc_rom_barb_east	false	main_3c
3c_legacy_navy_barb_east_four_wind_heralds	sc_rom_barb_east	false	main_3c
3c_legacy_navy_barb_east_larchen_prows	sc_rom_barb_east	false	main_3c
3c_legacy_navy_barb_east_sea_scourge	sc_rom_barb_east	false	main_3c
3c_legacy_navy_barb_east_storm_of_maeotis	sc_rom_barb_east	false	main_3c
3c_legacy_navy_barb_east_thagimasidas_children	sc_rom_barb_east	false	main_3c
3c_legacy_navy_brethren_of_ys	sc_rom_gaul	false	main_3c
3c_legacy_navy_briton_agrona_vengeance	sc_rom_british	false	main_3c
3c_legacy_navy_briton_nodens_wrath	sc_rom_british	false	main_3c
3c_legacy_navy_briton_sea_horses	sc_rom_british	false	main_3c
3c_legacy_navy_briton_sea_scourge	sc_rom_british	false	main_3c
3c_legacy_navy_briton_seekers_of_lyonesse	sc_rom_british	false	main_3c
3c_legacy_navy_briton_waves_crashing	sc_rom_british	false	main_3c
3c_legacy_navy_briton_winds_iron	sc_rom_british	false	main_3c
3c_legacy_navy_celtic_turbulence_divine	sc_rom_british	false	main_3c
3c_legacy_navy_celtic_waters_troubled	sc_rom_british	false	main_3c
3c_legacy_navy_celtic_widow_makers	sc_rom_british	false	main_3c
3c_legacy_navy_eastern_burning_waters	sc_rom_eastern	false	main_3c
3c_legacy_navy_eastern_dagon_will	sc_rom_eastern	false	main_3c
3c_legacy_navy_eastern_darius_pride	sc_rom_eastern	false	main_3c
3c_legacy_navy_eastern_salamis_grudge	sc_rom_eastern	false	main_3c
3c_legacy_navy_eastern_sea_dragons	sc_rom_eastern	false	main_3c
3c_legacy_navy_eastern_wanderers_windblown	sc_rom_eastern	false	main_3c
3c_legacy_navy_eastern_wave_cutters	sc_rom_eastern	false	main_3c
3c_legacy_navy_germanic_followers_of_the_whales_way	sc_rom_germanic	false	main_3c
3c_legacy_navy_germanic_jormungandr_eyes	sc_rom_germanic	false	main_3c
3c_legacy_navy_germanic_mad_raiders	sc_rom_germanic	false	main_3c
3c_legacy_navy_germanic_nyxes_heralds	sc_rom_germanic	false	main_3c
3c_legacy_navy_germanic_rhine_sons	sc_rom_germanic	false	main_3c
3c_legacy_navy_germanic_sea_scourge	sc_rom_germanic	false	main_3c
3c_legacy_navy_germanic_sea_serpents	sc_rom_germanic	false	main_3c
3c_legacy_navy_germanic_sea_steed_masters	sc_rom_germanic	false	main_3c
3c_legacy_navy_germanic_tides_amber	sc_rom_germanic	false	main_3c
3c_legacy_navy_germanic_wind_shields	sc_rom_germanic	false	main_3c
3c_legacy_navy_golden_voyagers	sc_rom_eastern	false	main_3c
3c_legacy_navy_palmyra_conquerors_of_mare_nostrum	sc_rom_roman	false	main_3c
3c_legacy_navy_palmyra_fleet_of_empress	sc_rom_roman	false	main_3c
3c_legacy_navy_palmyra_floating_castles	sc_rom_roman	false	main_3c
3c_legacy_navy_palmyra_masters_of_waves	sc_rom_roman	false	main_3c
3c_legacy_navy_palmyra_neptune_trident	sc_rom_roman	false	main_3c
3c_legacy_navy_palmyra_sunlight_sails	sc_rom_roman	false	main_3c
3c_legacy_navy_palmyra_the_leviathans	sc_rom_roman	false	main_3c
3c_legacy_navy_palmyra_tiamat_reborn	sc_rom_roman	false	main_3c
3c_legacy_navy_palmyra_warriors_of_dagon	sc_rom_roman	false	main_3c
3c_legacy_navy_palmyra_wind_spirits	sc_rom_roman	false	main_3c
3c_legacy_navy_palmyra_zenobia_sea_serpents	sc_rom_roman	false	main_3c
3c_legacy_navy_sea_people	sc_rom_african_arabian	false	main_3c
3c_legacy_navy_spice_masters	sc_rom_african_arabian	false	main_3c
3c_legacy_navy_wave_watchers	sc_rom_african_arabian	false	main_3c
3c_legacy_nomadic_arrows_of_goitosyros	sc_rom_barb_east	true	main_3c
3c_legacy_nomadic_howling_wolves	sc_rom_barb_east	true	main_3c
3c_legacy_nomadic_the_horde	sc_rom_barb_east	true	main_3c
3c_legacy_nomadic_waves_of_the_green_sea	sc_rom_barb_east	true	main_3c
3c_legacy_nomadic_yurt_burners	sc_rom_barb_east	true	main_3c
3c_legacy_palmyra_defenders_of_tadmor	sc_rom_roman	true	main_3c
3c_legacy_palmyra_legion_of_aglibol	sc_rom_roman	true	main_3c
3c_legacy_palmyra_legion_of_allat	sc_rom_roman	true	main_3c
3c_legacy_palmyra_legion_of_baal	sc_rom_roman	true	main_3c
3c_legacy_palmyra_legion_of_baalshamin	sc_rom_roman	true	main_3c
3c_legacy_palmyra_legion_of_elagabalus	sc_rom_roman	true	main_3c
3c_legacy_palmyra_legion_of_empress	sc_rom_roman	true	main_3c
3c_legacy_palmyra_legion_of_jupiter	sc_rom_roman	true	main_3c
3c_legacy_palmyra_legion_of_malakbel	sc_rom_roman	true	main_3c
3c_legacy_palmyra_legion_of_nabu	sc_rom_roman	true	main_3c
3c_legacy_palmyra_legion_of_yarhibol	sc_rom_roman	true	main_3c
3c_legacy_palmyra_odaenathus_veterans	sc_rom_roman	true	main_3c
3c_legacy_palmyra_vaballathus_warriors	sc_rom_roman	true	main_3c
3c_legacy_palmyra_vanquishers_of_east	sc_rom_roman	true	main_3c
3c_legacy_palmyra_zenobia_chosen	sc_rom_roman	true	main_3c
3c_legacy_parthian_arasaces_armour	sc_rom_eastern	true	main_3c
3c_legacy_parthian_black_quivers	sc_rom_eastern	true	main_3c
3c_legacy_parthian_fire_celerity_heralds	sc_rom_eastern	true	main_3c
3c_legacy_parthian_fire_fires_wrath	sc_rom_eastern	true	main_3c
3c_legacy_parthian_fire_purpose_executors	sc_rom_eastern	true	main_3c
3c_legacy_parthian_fire_victory_champions	sc_rom_eastern	true	main_3c
3c_legacy_parthian_karen_defenders	sc_rom_eastern	true	main_3c
3c_legacy_parthian_mithra_truth	sc_rom_eastern	true	main_3c
3c_legacy_parthian_parni_children	sc_rom_eastern	true	main_3c
3c_legacy_parthian_rostam_companions	sc_rom_eastern	true	main_3c
3c_legacy_parthian_surena_champions	sc_rom_eastern	true	main_3c
3c_legacy_parthian_verethragna_fury	sc_rom_eastern	true	main_3c
3c_legacy_parthian_xerxes_vengeance	sc_rom_eastern	true	main_3c
inv_legacy_champions_of_the_moon	sc_rom_nuragic	false	main_invasion
inv_legacy_champions_of_the_sun	sc_rom_nuragic	true	main_invasion
inv_legacy_children_of_uni	sc_rom_etruscan	true	main_invasion
inv_legacy_heralds_of_laran	sc_rom_etruscan	true	main_invasion
inv_legacy_heralds_of_the_moon	sc_rom_nuragic	false	main_invasion
inv_legacy_heralds_of_the_sun	sc_rom_nuragic	true	main_invasion
inv_legacy_heralds_of_tivr	sc_rom_etruscan	true	main_invasion
inv_legacy_heralds_of_usil	sc_rom_etruscan	true	main_invasion
inv_legacy_keepers_of_the_sacred_books	sc_rom_etruscan	true	main_invasion
inv_legacy_larans_chosen	sc_rom_etruscan	true	main_invasion
inv_legacy_masters_of_the_sea	sc_rom_etruscan	false	main_invasion
inv_legacy_messengers_of_babai	sc_rom_nuragic	true	main_invasion
inv_legacy_protectors_of_cel	sc_rom_etruscan	true	main_invasion
inv_legacy_sons_of_aristeus	sc_rom_nuragic	true	main_invasion
inv_legacy_sons_of_hercules	sc_rom_nuragic	true	main_invasion
inv_legacy_sons_of_hermes	sc_rom_nuragic	true	main_invasion
inv_legacy_sons_of_iolaus	sc_rom_nuragic	true	main_invasion
inv_legacy_sons_of_norax	sc_rom_nuragic	true	main_invasion
inv_legacy_sons_of_sardus	sc_rom_nuragic	true	main_invasion
inv_legacy_sons_of_tinia	sc_rom_etruscan	true	main_invasion
inv_legacy_the_balanced	sc_rom_etruscan	true	main_invasion
inv_legacy_the_bearded_wariors	sc_rom_etruscan	true	main_invasion
inv_legacy_the_brazen_bulls	sc_rom_italic	true	main_invasion
inv_legacy_the_bronze_warriors	sc_rom_etruscan	true	main_invasion
inv_legacy_the_bull_riders	sc_rom_nuragic	true	main_invasion
inv_legacy_the_conquerors	sc_rom_italic	true	main_invasion
inv_legacy_the_defenders_of_gremanu	sc_rom_nuragic	true	main_invasion
inv_legacy_the_divine_turbulence	sc_rom_italic	false	main_invasion
inv_legacy_the_free_men	sc_rom_etruscan	true	main_invasion
inv_legacy_the_gentle_giants	sc_rom_nuragic	true	main_invasion
inv_legacy_the_giant_slayers	sc_rom_nuragic	true	main_invasion
inv_legacy_the_giants_of_osono	sc_rom_nuragic	true	main_invasion
inv_legacy_the_glorious	sc_rom_italic	true	main_invasion
inv_legacy_the_great_warriors	sc_rom_italic	true	main_invasion
inv_legacy_the_howling_wolves	sc_rom_italic	true	main_invasion
inv_legacy_the_mountain_men	sc_rom_italic	true	main_invasion
inv_legacy_the_protectors_of_the_moon	sc_rom_nuragic	false	main_invasion
inv_legacy_the_protectors_of_the_sun	sc_rom_nuragic	true	main_invasion
inv_legacy_the_rocks_of_rasenna	sc_rom_etruscan	true	main_invasion
inv_legacy_the_sails_of_the_sun	sc_rom_etruscan	false	main_invasion
inv_legacy_the_stone_crows	sc_rom_italic	true	main_invasion
inv_legacy_the_stone_men	sc_rom_etruscan	true	main_invasion
inv_legacy_the_stone_men	sc_rom_italic	true	main_invasion
inv_legacy_the_storm_riders	sc_rom_italic	false	main_invasion
inv_legacy_the_troubled_waters	sc_rom_italic	false	main_invasion
inv_legacy_the_walkers	sc_rom_italic	true	main_invasion
inv_legacy_the_wall	sc_rom_etruscan	true	main_invasion
inv_legacy_the_wandering_warriors	sc_rom_italic	true	main_invasion
inv_legacy_the_warmongers	sc_rom_italic	true	main_invasion
inv_legacy_the_warriors_of_glory	sc_rom_italic	true	main_invasion
inv_legacy_the_widow_makers	sc_rom_italic	true	main_invasion
inv_legacy_the_winds_of_fortune	sc_rom_italic	false	main_invasion
inv_legacy_the_wrath_of_laran	sc_rom_etruscan	false	main_invasion
inv_legacy_warriors_of_the_moon	sc_rom_nuragic	false	main_invasion
inv_legacy_warriors_of_the_sea	sc_rom_etruscan	false	main_invasion
inv_legacy_warriors_of_the_sun	sc_rom_nuragic	true	main_invasion
legacy_afro_arabian_allatu_heralds	sc_rom_african_arabian	true	
legacy_afro_arabian_allatu_heralds	sc_rom_numidian	true	
legacy_afro_arabian_beasts_burden	sc_rom_african_arabian	true	
legacy_afro_arabian_beasts_burden	sc_rom_numidian	true	
legacy_afro_arabian_bronze_warriors	sc_rom_african_arabian	true	
legacy_afro_arabian_bronze_warriors	sc_rom_numidian	true	
legacy_afro_arabian_death_merchants	sc_rom_african_arabian	true	
legacy_afro_arabian_death_merchants	sc_rom_numidian	true	
legacy_afro_arabian_desert_guardians	sc_rom_african_arabian	true	
legacy_afro_arabian_desert_guardians	sc_rom_numidian	true	
legacy_afro_arabian_desert_old_men	sc_rom_african_arabian	true	
legacy_afro_arabian_desert_old_men	sc_rom_numidian	true	
legacy_afro_arabian_desert_scorpions	sc_rom_african_arabian	true	
legacy_afro_arabian_desert_scorpions	sc_rom_numidian	true	
legacy_afro_arabian_desert_snakes	sc_rom_african_arabian	true	
legacy_afro_arabian_desert_snakes	sc_rom_numidian	true	
legacy_afro_arabian_desert_wind	sc_rom_african_arabian	true	
legacy_afro_arabian_desert_wind	sc_rom_numidian	true	
legacy_afro_arabian_gurzil_horns	sc_rom_african_arabian	true	
legacy_afro_arabian_gurzil_horns	sc_rom_numidian	true	
legacy_afro_arabian_lords_war	sc_rom_african_arabian	true	
legacy_afro_arabian_lords_war	sc_rom_numidian	true	
legacy_afro_arabian_mahrem_sons	sc_rom_african_arabian	true	
legacy_afro_arabian_mahrem_sons	sc_rom_numidian	true	
legacy_afro_arabian_nomads_dread	sc_rom_african_arabian	true	
legacy_afro_arabian_nomads_dread	sc_rom_numidian	true	
legacy_afro_arabian_sand_sentinels	sc_rom_african_arabian	true	
legacy_afro_arabian_sand_sentinels	sc_rom_numidian	true	
legacy_afro_arabian_sands_burning	sc_rom_african_arabian	true	
legacy_afro_arabian_sands_burning	sc_rom_numidian	true	
legacy_afro_arabian_stone_burners	sc_rom_african_arabian	true	
legacy_afro_arabian_stone_burners	sc_rom_numidian	true	
legacy_afro_arabian_sun_children	sc_rom_african_arabian	true	
legacy_afro_arabian_sun_children	sc_rom_numidian	true	
legacy_afro_arabian_sun_warriors	sc_rom_african_arabian	true	
legacy_afro_arabian_sun_warriors	sc_rom_numidian	true	
legacy_afro_arabian_warriors_fortune	sc_rom_african_arabian	true	
legacy_afro_arabian_warriors_fortune	sc_rom_numidian	true	
legacy_army_daco_thracian_bendis_chosen	sc_rom_daco_thracian	true	
legacy_army_daco_thracian_blades	sc_rom_daco_thracian	true	
legacy_army_daco_thracian_followers_kotys	sc_rom_daco_thracian	true	
legacy_army_daco_thracian_fury_gebelizis	sc_rom_daco_thracian	true	
legacy_army_daco_thracian_fury	sc_rom_daco_thracian	true	
legacy_army_daco_thracian_heralds_death	sc_rom_daco_thracian	true	
legacy_army_daco_thracian_pillagers	sc_rom_daco_thracian	true	
legacy_army_daco_thracian_raiders	sc_rom_daco_thracian	true	
legacy_army_daco_thracian_sabazios	sc_rom_daco_thracian	true	
legacy_army_daco_thracian_spear_men	sc_rom_daco_thracian	true	
legacy_army_daco_thracian_unbreakable_shields	sc_rom_daco_thracian	true	
legacy_army_illyrian_blades	sc_rom_iapygian	true	main_invasion
legacy_army_illyrian_blades	sc_rom_illyrian	true	
legacy_army_illyrian_fury_medaurus	sc_rom_iapygian	true	main_invasion
legacy_army_illyrian_fury_medaurus	sc_rom_illyrian	true	
legacy_army_illyrian_fury	sc_rom_iapygian	true	main_invasion
legacy_army_illyrian_fury	sc_rom_illyrian	true	
legacy_army_illyrian_glory_vidasus	sc_rom_iapygian	true	main_invasion
legacy_army_illyrian_glory_vidasus	sc_rom_illyrian	true	
legacy_army_illyrian_heralds_death	sc_rom_iapygian	true	main_invasion
legacy_army_illyrian_heralds_death	sc_rom_illyrian	true	
legacy_army_illyrian_pillagers	sc_rom_iapygian	true	main_invasion
legacy_army_illyrian_pillagers	sc_rom_illyrian	true	
legacy_army_illyrian_raiders	sc_rom_iapygian	true	main_invasion
legacy_army_illyrian_raiders	sc_rom_illyrian	true	
legacy_army_illyrian_spear_men	sc_rom_iapygian	true	main_invasion
legacy_army_illyrian_spear_men	sc_rom_illyrian	true	
legacy_army_illyrian_unbreakable_shields	sc_rom_iapygian	true	main_invasion
legacy_army_illyrian_unbreakable_shields	sc_rom_illyrian	true	
legacy_army_illyrian_wrath_armatus	sc_rom_iapygian	true	main_invasion
legacy_army_illyrian_wrath_armatus	sc_rom_illyrian	true	
legacy_barb_east_agin_blades	sc_rom_barb_east	true	
legacy_barb_east_api_defenders	sc_rom_barb_east	true	
legacy_barb_east_battle_axes	sc_rom_barb_east	true	
legacy_barb_east_blades_of_grass	sc_rom_barb_east	true	
legacy_barb_east_blood_riders	sc_rom_barb_east	true	
legacy_barb_east_bloodletters	sc_rom_barb_east	true	
legacy_barb_east_drifters	sc_rom_barb_east	true	
legacy_barb_east_gales_of_wind	sc_rom_barb_east	true	
legacy_barb_east_golden_army	sc_rom_barb_east	true	
legacy_barb_east_husbands_of_amazons	sc_rom_barb_east	true	
legacy_barb_east_hyperboria	sc_rom_barb_east	true	
legacy_barb_east_larch_children	sc_rom_barb_east	true	
legacy_barb_east_nomads_dread	sc_rom_barb_east	true	
legacy_barb_east_oitosyros_will	sc_rom_barb_east	true	
legacy_barb_east_papaios_champions	sc_rom_barb_east	true	
legacy_barb_east_poison_arrows	sc_rom_barb_east	true	
legacy_barb_east_riders_rough	sc_rom_barb_east	true	
legacy_barb_east_riders_swift	sc_rom_barb_east	true	
legacy_barb_east_sacrificers	sc_rom_barb_east	true	
legacy_barb_east_seekers_of_destiny	sc_rom_barb_east	true	
legacy_barb_east_skulls_golden	sc_rom_barb_east	true	
legacy_barb_east_steeds_doom	sc_rom_barb_east	true	
legacy_barb_east_steppe_fury	sc_rom_barb_east	true	
legacy_barb_east_steppe_scourge	sc_rom_barb_east	true	
legacy_barb_east_steppe_storm	sc_rom_barb_east	true	
legacy_barb_east_steppe_wanderers	sc_rom_barb_east	true	
legacy_barb_east_steppe_wolves	sc_rom_barb_east	true	
legacy_barb_east_strength_of_api	sc_rom_barb_east	true	
legacy_barb_east_tabiti_flames	sc_rom_barb_east	true	
legacy_barb_east_wayward_warriors	sc_rom_barb_east	true	
legacy_barb_east_wild_ones	sc_rom_barb_east	true	
legacy_briton_albion_champions	sc_rom_british	true	
legacy_briton_andraste_will	sc_rom_british	true	
legacy_briton_belatucadros_blades	sc_rom_british	true	
legacy_briton_brutus_children	sc_rom_british	true	
legacy_briton_burning_men	sc_rom_british	true	
legacy_briton_camulos_horns	sc_rom_british	true	
legacy_briton_cocidius_hunters	sc_rom_british	true	
legacy_briton_ebraucus_vanquishers	sc_rom_british	true	
legacy_briton_iron_fist	sc_rom_british	true	
legacy_briton_mists_doom	sc_rom_british	true	
legacy_briton_morrigan_consorts	sc_rom_british	true	
legacy_briton_spear_runners	sc_rom_british	true	
legacy_briton_stags_noble	sc_rom_british	true	
legacy_briton_sword_power	sc_rom_british	true	
legacy_briton_woad_warriors	sc_rom_british	true	
legacy_carthage_defenders_new_city	sc_rom_carthaginian	true	
legacy_carthage_mago_pride	sc_rom_carthaginian	true	
legacy_carthage_sacred_army	sc_rom_carthaginian	true	
legacy_carthaginian_adirim_protectors	sc_rom_carthaginian	true	
legacy_carthaginian_ambassadors_of_atlas	sc_rom_carthaginian	true	
legacy_carthaginian_brethren_of_ball	sc_rom_carthaginian	true	
legacy_carthaginian_dido_faithful	sc_rom_carthaginian	true	
legacy_carthaginian_hamilcar_fists	sc_rom_carthaginian	true	
legacy_carthaginian_heir_phoenicia	sc_rom_carthaginian	true	
legacy_carthaginian_hundred_four_friends	sc_rom_carthaginian	true	
legacy_carthaginian_hundred_four_heralds	sc_rom_carthaginian	true	
legacy_carthaginian_judges_will	sc_rom_carthaginian	true	
legacy_carthaginian_melqart_justice	sc_rom_carthaginian	true	
legacy_carthaginian_people_army	sc_rom_carthaginian	true	
legacy_carthaginian_resheph_scourge	sc_rom_carthaginian	true	
legacy_carthaginian_tanit_lions	sc_rom_carthaginian	true	
legacy_carthaginian_tusks_of_destiny	sc_rom_carthaginian	true	
legacy_carthaginian_walls_byrsa	sc_rom_carthaginian	true	
legacy_celtiberian_ataecina_heralds	sc_rom_celtiberian	true	
legacy_celtiberian_candamius_reach	sc_rom_celtiberian	true	
legacy_celtiberian_cariocecus_right_hands	sc_rom_celtiberian	true	
legacy_celtiberian_cariocecus_wrath	sc_rom_celtiberian	true	
legacy_celtiberian_cesius_spears	sc_rom_celtiberian	true	
legacy_celtiberian_endovelicus_guardians	sc_rom_celtiberian	true	
legacy_celtiberian_epane_steeds	sc_rom_celtiberian	true	
legacy_celtiberian_flaming_falcatas	sc_rom_celtiberian	true	
legacy_celtiberian_neto_blazing_fury	sc_rom_celtiberian	true	
legacy_celtiberian_neto_flaming_swords	sc_rom_celtiberian	true	
legacy_celtiberian_neto_horns	sc_rom_celtiberian	true	
legacy_celtiberian_reu_thunderbolts	sc_rom_celtiberian	true	
legacy_celtiberian_trebaruna_champions	sc_rom_celtiberian	true	
legacy_celtic_artio_claws	sc_rom_celtic	true	
legacy_celtic_blades	sc_rom_celtic	true	
legacy_celtic_brazen_bears	sc_rom_celtic	true	
legacy_celtic_epona_glory	sc_rom_celtic	true	
legacy_celtic_heralds_of_death	sc_rom_celtic	true	
legacy_celtic_howling_wolves	sc_rom_celtic	true	
legacy_celtic_mountain_men	sc_rom_celtic	true	
legacy_celtic_sabazios_fury	sc_rom_celtic	true	
legacy_celtic_smertrios_sons	sc_rom_celtic	true	
legacy_celtic_spear_men	sc_rom_celtic	true	
legacy_celtic_stone_crows	sc_rom_celtic	true	
legacy_celtic_tumult	sc_rom_celtic	true	
legacy_celtic_warmongers	sc_rom_celtic	true	
legacy_celtic_warriors_wandering	sc_rom_celtic	true	
legacy_eastern_army_immortals	sc_rom_eastern	true	
legacy_eastern_brothers_arms	sc_rom_eastern	true	
legacy_eastern_fire_steel	sc_rom_eastern	true	
legacy_eastern_first_men	sc_rom_eastern	true	
legacy_eastern_flames_pruifying	sc_rom_eastern	true	
legacy_eastern_forgotten_warriors	sc_rom_eastern	true	
legacy_eastern_heroes_men	sc_rom_eastern	true	
legacy_eastern_ishtar_champions	sc_rom_eastern	true	
legacy_eastern_light_bringers	sc_rom_eastern	true	
legacy_eastern_manticore_claws	sc_rom_eastern	true	
legacy_eastern_serpent_eyes	sc_rom_eastern	true	
legacy_eastern_stone_cutters	sc_rom_eastern	true	
legacy_eastern_truth_bearers	sc_rom_eastern	true	
legacy_eastern_watchmen	sc_rom_parthian	true	
legacy_eastern_watch	sc_rom_eastern	true	
legacy_eastern_xerxes_scions	sc_rom_eastern	true	
legacy_gaul_andarta_claws	sc_rom_gaul	true	
legacy_gaul_armorican_champions	sc_rom_gaul	true	
legacy_gaul_brennus_sons	sc_rom_gaul	true	
legacy_gaul_catubodua_flight	sc_rom_gaul	true	
legacy_gaul_cernunos_horns	sc_rom_gaul	true	
legacy_gaul_children_of_morgane	sc_rom_gaul	true	
legacy_gaul_doom_men	sc_rom_gaul	true	
legacy_gaul_golden_torcs	sc_rom_gaul	true	
legacy_gaul_headhunters	sc_rom_gaul	true	
legacy_gaul_heralds_of_ankou	sc_rom_gaul	true	
legacy_gaul_hill_defenders	sc_rom_gaul	true	
legacy_gaul_howling_carnyces	sc_rom_gaul	true	
legacy_gaul_korrigans	sc_rom_gaul	true	
legacy_gaul_light_belenos	sc_rom_gaul	true	
legacy_gaul_men_of_morvan	sc_rom_gaul	true	
legacy_gaul_menhir_men	sc_rom_gaul	true	
legacy_gaul_razorback	sc_rom_gaul	true	
legacy_gaul_rolling_menhirs	sc_rom_gaul	true	
legacy_gaul_rudianos_champions	sc_rom_gaul	true	
legacy_gaul_segomo_swords	sc_rom_gaul	true	
legacy_gaul_stalkers_of_camma	sc_rom_gaul	true	
legacy_gaul_swords_glory	sc_rom_gaul	true	
legacy_gaul_taranis_thunderbolts	sc_rom_gaul	true	
legacy_gaul_toutatis_wardens	sc_rom_gaul	true	
legacy_germanic_beholder_tuisto_skull	sc_rom_germanic	true	
legacy_germanic_berserkers_dread	sc_rom_germanic	true	
legacy_germanic_blood_embers	sc_rom_germanic	true	
legacy_germanic_bloodaxes	sc_rom_germanic	true	
legacy_germanic_bloodsworn	sc_rom_germanic	true	
legacy_germanic_breakers_of_trees	sc_rom_germanic	true	
legacy_germanic_brothers_metal	sc_rom_germanic	true	
legacy_germanic_children_of_the_forest	sc_rom_germanic	true	
legacy_germanic_doom_children	sc_rom_germanic	true	
legacy_germanic_dragonslayers	sc_rom_germanic	true	
legacy_germanic_einherjars	sc_rom_germanic	true	
legacy_germanic_feeder_of_war_gull	sc_rom_germanic	true	
legacy_germanic_feeders_of_eagle	sc_rom_germanic	true	
legacy_germanic_fimmilena_victors	sc_rom_germanic	true	
legacy_germanic_fires_sunna	sc_rom_germanic	true	
legacy_germanic_friagabis_champions	sc_rom_germanic	true	
legacy_germanic_frijjo_consorts	sc_rom_germanic	true	
legacy_germanic_heralds_of_hymir	sc_rom_germanic	true	
legacy_germanic_howling_wolves	sc_rom_germanic	true	
legacy_germanic_icicles_of_blood	sc_rom_germanic	true	
legacy_germanic_jotun_slayers	sc_rom_germanic	true	
legacy_germanic_lightning_riders	sc_rom_germanic	true	
legacy_germanic_minions_of_wolf_father	sc_rom_germanic	true	
legacy_germanic_oak_children	sc_rom_germanic	true	
legacy_germanic_oath_maker	sc_rom_germanic	true	
legacy_germanic_raging_boars	sc_rom_germanic	true	
legacy_germanic_skull_breaker	sc_rom_germanic	true	
legacy_germanic_sons_of_bears	sc_rom_germanic	true	
legacy_germanic_swans_of_blood	sc_rom_germanic	true	
legacy_germanic_thryms_chosen	sc_rom_germanic	true	
legacy_germanic_thunaraz_hammer	sc_rom_germanic	true	
legacy_germanic_thunaraz_thunderbolts	sc_rom_germanic	true	
legacy_germanic_trees_woe	sc_rom_germanic	true	
legacy_germanic_warrior_skalds	sc_rom_germanic	true	
legacy_germanic_wild_hunters	sc_rom_germanic	true	
legacy_germanic_wodanaz_host	sc_rom_germanic	true	
legacy_germanic_wolves_war	sc_rom_germanic	true	
legacy_germanic_wooden_men	sc_rom_germanic	true	
legacy_greek_agamemnon_pride	sc_rom_greek	true	
legacy_greek_ares_dread	sc_rom_greek	true	
legacy_greek_ares_sons	sc_rom_greek	true	
legacy_greek_ares_spears	sc_rom_greek	true	
legacy_greek_ares_terrors	sc_rom_greek	true	
legacy_greek_athena_faithful	sc_rom_greek	true	
legacy_greek_baslisk_bite	sc_rom_greek	true	
legacy_greek_centaurs	sc_rom_greek	true	
legacy_greek_companions_brave	sc_rom_greek	true	
legacy_greek_companions_heracles	sc_rom_greek	true	
legacy_greek_companions_of_cerberus	sc_rom_greek	true	
legacy_greek_deimos_dread	sc_rom_greek	true	
legacy_greek_enemies_of_circe	sc_rom_greek	true	
legacy_greek_enyo_destroyers	sc_rom_greek	true	
legacy_greek_gigantes	sc_rom_greek	true	
legacy_greek_gods_war	sc_rom_greek	true	
legacy_greek_gryphon_grace	sc_rom_greek	true	
legacy_greek_harpy_claws	sc_rom_greek	true	
legacy_greek_hecatoncheires	sc_rom_greek	true	
legacy_greek_helene_faithful	sc_rom_greek	true	
legacy_greek_hephaistos_fires	sc_rom_greek	true	
legacy_greek_hephaistos_hammers	sc_rom_greek	true	
legacy_greek_heracles_might	sc_rom_greek	true	
legacy_greek_inv_agamemnon_pride	sc_rom_greek	true	main_invasion
legacy_greek_inv_ares_dread	sc_rom_greek	true	main_invasion
legacy_greek_inv_ares_sons	sc_rom_greek	true	main_invasion
legacy_greek_inv_ares_spears	sc_rom_greek	true	main_invasion
legacy_greek_inv_ares_terrors	sc_rom_greek	true	main_invasion
legacy_greek_inv_athena_faithful	sc_rom_greek	true	main_invasion
legacy_greek_inv_baslisk_bite	sc_rom_greek	true	main_invasion
legacy_greek_inv_centaurs	sc_rom_greek	true	main_invasion
legacy_greek_inv_companions_brave	sc_rom_greek	true	main_invasion
legacy_greek_inv_companions_heracles	sc_rom_greek	true	main_invasion
legacy_greek_inv_companions_of_cerberus	sc_rom_greek	true	main_invasion
legacy_greek_inv_deimos_dread	sc_rom_greek	true	main_invasion
legacy_greek_inv_enemies_of_circe	sc_rom_greek	true	main_invasion
legacy_greek_inv_enyo_destroyers	sc_rom_greek	true	main_invasion
legacy_greek_inv_gigantes	sc_rom_greek	true	main_invasion
legacy_greek_inv_gods_war	sc_rom_greek	true	main_invasion
legacy_greek_inv_gryphon_grace	sc_rom_greek	true	main_invasion
legacy_greek_inv_harpy_claws	sc_rom_greek	true	main_invasion
legacy_greek_inv_hecatoncheires	sc_rom_greek	true	main_invasion
legacy_greek_inv_helene_faithful	sc_rom_greek	true	main_invasion
legacy_greek_inv_hephaistos_fires	sc_rom_greek	true	main_invasion
legacy_greek_inv_hephaistos_hammers	sc_rom_greek	true	main_invasion
legacy_greek_inv_heracles_might	sc_rom_greek	true	main_invasion
legacy_greek_inv_medusa_head_wielders	sc_rom_greek	true	main_invasion
legacy_greek_inv_nike_champions	sc_rom_greek	true	main_invasion
legacy_greek_inv_odysseus_wanderers	sc_rom_greek	true	main_invasion
legacy_greek_inv_olympus_champions	sc_rom_greek	true	main_invasion
legacy_greek_inv_olympus_defenders	sc_rom_greek	true	main_invasion
legacy_greek_inv_pegasus_wings	sc_rom_greek	true	main_invasion
legacy_greek_inv_pericles_heraclids	sc_rom_greek	true	main_invasion
legacy_greek_inv_pericles_pride	sc_rom_greek	true	main_invasion
legacy_greek_inv_phobos_terror	sc_rom_greek	true	main_invasion
legacy_greek_inv_polemos_daemons	sc_rom_greek	true	main_invasion
legacy_greek_inv_ravaging_chimeras	sc_rom_greek	true	main_invasion
legacy_greek_inv_servants_of_charon	sc_rom_greek	true	main_invasion
legacy_greek_inv_sons_of_rhea	sc_rom_greek	true	main_invasion
legacy_greek_inv_ten_thousand	sc_rom_greek	true	main_invasion
legacy_greek_inv_thanatos_heralds	sc_rom_greek	true	main_invasion
legacy_greek_inv_the_cyclops_slayers	sc_rom_greek	true	main_invasion
legacy_greek_inv_titanes	sc_rom_greek	true	main_invasion
legacy_greek_inv_tyche_children	sc_rom_greek	true	main_invasion
legacy_greek_inv_xenophon_brothers	sc_rom_greek	true	main_invasion
legacy_greek_inv_zeus_children	sc_rom_greek	true	main_invasion
legacy_greek_inv_zeus_eagles	sc_rom_greek	true	main_invasion
legacy_greek_inv_zeus_thunderbolts	sc_rom_greek	true	main_invasion
legacy_greek_medusa_head_wielders	sc_rom_greek	true	
legacy_greek_nike_champions	sc_rom_greek	true	
legacy_greek_odysseus_wanderers	sc_rom_greek	true	
legacy_greek_olympus_champions	sc_rom_greek	true	
legacy_greek_olympus_defenders	sc_rom_greek	true	
legacy_greek_pegasus_wings	sc_rom_greek	true	
legacy_greek_pericles_heraclids	sc_rom_greek	true	
legacy_greek_pericles_pride	sc_rom_greek	true	
legacy_greek_phobos_terror	sc_rom_greek	true	
legacy_greek_polemos_daemons	sc_rom_greek	true	
legacy_greek_ravaging_chimeras	sc_rom_greek	true	
legacy_greek_servants_of_charon	sc_rom_greek	true	
legacy_greek_sons_of_rhea	sc_rom_greek	true	
legacy_greek_ten_thousand	sc_rom_greek	true	
legacy_greek_thanatos_heralds	sc_rom_greek	true	
legacy_greek_the_cyclops_slayers	sc_rom_greek	true	
legacy_greek_titanes	sc_rom_greek	true	
legacy_greek_tyche_children	sc_rom_greek	true	
legacy_greek_xenophon_brothers	sc_rom_greek	true	
legacy_greek_zeus_children	sc_rom_greek	true	
legacy_greek_zeus_eagles	sc_rom_greek	true	
legacy_greek_zeus_thunderbolts	sc_rom_greek	true	
legacy_italian_aritimi_arrows	sc_rom_roman	true	
legacy_italian_aritimi_herd	sc_rom_roman	true	
legacy_italian_champions_uni	sc_rom_roman	true	
legacy_italian_februus_harbingers	sc_rom_roman	true	
legacy_italian_laran_spears	sc_rom_roman	true	
legacy_italian_latinus_champions	sc_rom_roman	true	
legacy_italian_leinth_heralds	sc_rom_roman	true	
legacy_italian_menrva_shields	sc_rom_roman	true	
legacy_italian_menrva_spears	sc_rom_roman	true	
legacy_italian_nine_gods_thunderbolts	sc_rom_roman	true	
legacy_italian_sethlans_hammers	sc_rom_roman	true	
legacy_italian_tinia_eagles	sc_rom_roman	true	
legacy_italian_tinia_thunderbolts	sc_rom_roman	true	
legacy_italian_tuchulcha_serpents	sc_rom_roman	true	
legacy_italian_veive_vengeance	sc_rom_roman	true	
legacy_italian_voltumna_faithful	sc_rom_roman	true	
legacy_naval_celtiberian_bandua_will	sc_rom_celtiberian	false	
legacy_naval_celtiberian_duberdico_chosen	sc_rom_celtiberian	false	
legacy_naval_celtiberian_durius_shoal	sc_rom_celtiberian	false	
legacy_naval_celtiberian_nabia_storms	sc_rom_celtiberian	false	
legacy_naval_celtic_ritona_peace	sc_rom_celtic	false	
legacy_navy_afro_arabian_sea_scourge	sc_rom_african_arabian	false	
legacy_navy_afro_arabian_sea_scourge	sc_rom_numidian	false	
legacy_navy_amber_warrior	sc_rom_germanic	false	
legacy_navy_atargatis_champions	sc_rom_eastern	false	
legacy_navy_barb_east_agrimpasa_pride	sc_rom_barb_east	false	
legacy_navy_barb_east_black_waters	sc_rom_barb_east	false	
legacy_navy_barb_east_dark_tides	sc_rom_barb_east	false	
legacy_navy_barb_east_four_wind_heralds	sc_rom_barb_east	false	
legacy_navy_barb_east_larchen_prows	sc_rom_barb_east	false	
legacy_navy_barb_east_sea_scourge	sc_rom_barb_east	false	
legacy_navy_barb_east_storm_of_maeotis	sc_rom_barb_east	false	
legacy_navy_barb_east_thagimasidas_children	sc_rom_barb_east	false	
legacy_navy_brethren_of_ys	sc_rom_gaul	false	
legacy_navy_briton_agrona_vengeance	sc_rom_british	false	
legacy_navy_briton_nodens_wrath	sc_rom_british	false	
legacy_navy_briton_sea_horses	sc_rom_british	false	
legacy_navy_briton_sea_scourge	sc_rom_british	false	
legacy_navy_briton_seekers_of_lyonesse	sc_rom_british	false	
legacy_navy_briton_waves_crashing	sc_rom_british	false	
legacy_navy_briton_winds_iron	sc_rom_british	false	
legacy_navy_carthaginian_colony_defenders	sc_rom_carthaginian	false	
legacy_navy_carthaginian_hanno_navigators	sc_rom_carthaginian	false	
legacy_navy_carthaginian_hippocamp_winged	sc_rom_carthaginian	false	
legacy_navy_carthaginian_leviathans	sc_rom_carthaginian	false	
legacy_navy_carthaginian_phoenicia_wanderers	sc_rom_carthaginian	false	
legacy_navy_carthaginian_scions_of_tyros	sc_rom_carthaginian	false	
legacy_navy_carthaginian_seven_seas	sc_rom_carthaginian	false	
legacy_navy_carthaginian_sidon_scions	sc_rom_carthaginian	false	
legacy_navy_carthaginian_wayfarers	sc_rom_carthaginian	false	
legacy_navy_carthaginian_yam_will	sc_rom_carthaginian	false	
legacy_navy_celtic_latobius_winds	sc_rom_celtic	false	
legacy_navy_celtic_turbulence_divine	sc_rom_celtic	false	
legacy_navy_celtic_waters_troubled	sc_rom_celtic	false	
legacy_navy_celtic_widow_makers	sc_rom_celtic	false	
legacy_navy_daco_thracian_divine_turbulence	sc_rom_daco_thracian	false	
legacy_navy_daco_thracian_raiders_sea	sc_rom_daco_thracian	false	
legacy_navy_daco_thracian_terrors_sea	sc_rom_daco_thracian	false	
legacy_navy_daco_thracian_troubled_waters	sc_rom_daco_thracian	false	
legacy_navy_daco_thracian_widow_makers	sc_rom_daco_thracian	false	
legacy_navy_eastern_burning_waters	sc_rom_eastern	false	
legacy_navy_eastern_dagon_will	sc_rom_eastern	false	
legacy_navy_eastern_darius_pride	sc_rom_eastern	false	
legacy_navy_eastern_salamis_grudge	sc_rom_eastern	false	
legacy_navy_eastern_sea_dragons	sc_rom_eastern	false	
legacy_navy_eastern_wanderers_windblown	sc_rom_eastern	false	
legacy_navy_eastern_wave_cutters	sc_rom_eastern	false	
legacy_navy_gaul_drowned_men	sc_rom_gaul	false	
legacy_navy_gaul_oak_riders	sc_rom_gaul	false	
legacy_navy_gaul_riders_storm	sc_rom_gaul	false	
legacy_navy_gaul_sail_masters	sc_rom_gaul	false	
legacy_navy_gaul_sea_scourge	sc_rom_gaul	false	
legacy_navy_gaul_taranis_winds	sc_rom_gaul	false	
legacy_navy_gaul_winds_vengeance	sc_rom_gaul	false	
legacy_navy_germanic_followers_of_the_whales_way	sc_rom_germanic	false	
legacy_navy_germanic_jormungandr_eyes	sc_rom_germanic	false	
legacy_navy_germanic_mad_raiders	sc_rom_germanic	false	
legacy_navy_germanic_nyxes_heralds	sc_rom_germanic	false	
legacy_navy_germanic_rhine_sons	sc_rom_germanic	false	
legacy_navy_germanic_sea_scourge	sc_rom_germanic	false	
legacy_navy_germanic_sea_serpents	sc_rom_germanic	false	
legacy_navy_germanic_sea_steed_masters	sc_rom_germanic	false	
legacy_navy_germanic_tides_amber	sc_rom_germanic	false	
legacy_navy_germanic_wind_shields	sc_rom_germanic	false	
legacy_navy_golden_voyagers	sc_rom_eastern	false	
legacy_navy_greek_amphitrite_champions	sc_rom_greek	false	
legacy_navy_greek_amphitrite_children	sc_rom_greek	false	
legacy_navy_greek_atlantis_vengeance	sc_rom_greek	false	
legacy_navy_greek_brizo_ward	sc_rom_greek	false	
legacy_navy_greek_charybdis_terror	sc_rom_greek	false	
legacy_navy_greek_friends_nereids	sc_rom_greek	false	
legacy_navy_greek_glaucus_heralds	sc_rom_greek	false	
legacy_navy_greek_hydra_heads	sc_rom_greek	false	
legacy_navy_greek_inv_amphitrite_champions	sc_rom_greek	false	main_invasion
legacy_navy_greek_inv_amphitrite_children	sc_rom_greek	false	main_invasion
legacy_navy_greek_inv_atlantis_vengeance	sc_rom_greek	false	main_invasion
legacy_navy_greek_inv_brizo_ward	sc_rom_greek	false	main_invasion
legacy_navy_greek_inv_charybdis_terror	sc_rom_greek	false	main_invasion
legacy_navy_greek_inv_friends_nereids	sc_rom_greek	false	main_invasion
legacy_navy_greek_inv_glaucus_heralds	sc_rom_greek	false	main_invasion
legacy_navy_greek_inv_hydra_heads	sc_rom_greek	false	main_invasion
legacy_navy_greek_inv_masters_of_mesogeios	sc_rom_greek	false	main_invasion
legacy_navy_greek_inv_okeanos	sc_rom_greek	false	main_invasion
legacy_navy_greek_inv_poseidon_chosen	sc_rom_greek	false	main_invasion
legacy_navy_greek_inv_poseidon_tridents	sc_rom_greek	false	main_invasion
legacy_navy_greek_inv_sirens_of_mesogeios	sc_rom_greek	false	main_invasion
legacy_navy_greek_inv_terror_scylla	sc_rom_greek	false	main_invasion
legacy_navy_greek_inv_triton_heralds	sc_rom_greek	false	main_invasion
legacy_navy_greek_inv_uranus_winds	sc_rom_greek	false	main_invasion
legacy_navy_greek_masters_of_mesogeios	sc_rom_greek	false	
legacy_navy_greek_okeanos	sc_rom_greek	false	
legacy_navy_greek_poseidon_chosen	sc_rom_greek	false	
legacy_navy_greek_poseidon_tridents	sc_rom_greek	false	
legacy_navy_greek_pytheas_navigators	sc_rom_greek	false	
legacy_navy_greek_sirens_of_mesogeios	sc_rom_greek	false	
legacy_navy_greek_terror_scylla	sc_rom_greek	false	
legacy_navy_greek_thessalonike_judgment	sc_rom_greek	false	
legacy_navy_greek_triton_heralds	sc_rom_greek	false	
legacy_navy_greek_uranus_winds	sc_rom_greek	false	
legacy_navy_illyrian_divine_turbulence	sc_rom_iapygian	false	main_invasion
legacy_navy_illyrian_divine_turbulence	sc_rom_illyrian	false	
legacy_navy_illyrian_raiders_sea	sc_rom_iapygian	false	main_invasion
legacy_navy_illyrian_raiders_sea	sc_rom_illyrian	false	
legacy_navy_illyrian_terrors_sea	sc_rom_iapygian	false	main_invasion
legacy_navy_illyrian_terrors_sea	sc_rom_illyrian	false	
legacy_navy_illyrian_troubled_waters	sc_rom_iapygian	false	main_invasion
legacy_navy_illyrian_troubled_waters	sc_rom_illyrian	false	
legacy_navy_illyrian_widow_makers	sc_rom_iapygian	false	main_invasion
legacy_navy_illyrian_widow_makers	sc_rom_illyrian	false	
legacy_navy_illyrian_wrath_bindus	sc_rom_iapygian	false	main_invasion
legacy_navy_illyrian_wrath_bindus	sc_rom_illyrian	false	
legacy_navy_italian_adriatic_storms	sc_rom_roman	false	
legacy_navy_italian_nethuns_dolphins	sc_rom_roman	false	
legacy_navy_italian_nethuns_tridents	sc_rom_roman	false	
legacy_navy_italian_tyrrhenian_defenders	sc_rom_roman	false	
legacy_navy_italian_winds_ani	sc_rom_roman	false	
legacy_navy_parthia_serpents_sea	sc_rom_parthian	false	
legacy_navy_parthian_anahita_faithful	sc_rom_parthian	false	
legacy_navy_parthian_purity_avan	sc_rom_parthian	false	
legacy_navy_parthian_storm_lords	sc_rom_parthian	false	
legacy_navy_parthian_tides_crimson	sc_rom_parthian	false	
legacy_navy_pontic_amphitrite_champions	sc_rom_pontic	false	
legacy_navy_pontic_charybdis_terror	sc_rom_pontic	false	
legacy_navy_pontic_friends_nereids	sc_rom_pontic	false	
legacy_navy_pontic_poseidon_chosen	sc_rom_pontic	false	
legacy_navy_pontic_terror_scylla	sc_rom_pontic	false	
legacy_navy_pontic_triton_heralds	sc_rom_pontic	false	
legacy_navy_pontus_argonaut_children	sc_rom_pontic	false	
legacy_navy_pontus_pontos_guardians	sc_rom_pontic	false	
legacy_navy_ptolemaic_nile_children	sc_rom_egyptian	false	
legacy_navy_ptolemaic_ptah_heralds	sc_rom_egyptian	false	
legacy_navy_ptolemaic_storm_eyes	sc_rom_egyptian	false	
legacy_navy_ptolemaic_tides_azure	sc_rom_egyptian	false	
legacy_navy_ptolemaic_two_lands_pride	sc_rom_egyptian	false	
legacy_navy_sea_people	sc_rom_african_arabian	false	
legacy_navy_sea_people	sc_rom_numidian	false	
legacy_navy_spice_masters	sc_rom_african_arabian	false	
legacy_navy_spice_masters	sc_rom_numidian	false	
legacy_navy_wave_watchers	sc_rom_african_arabian	false	
legacy_navy_wave_watchers	sc_rom_numidian	false	
legacy_nomadic_arrows_of_goitosyros	sc_rom_barb_east	true	
legacy_nomadic_howling_wolves	sc_rom_barb_east	true	
legacy_nomadic_the_horde	sc_rom_barb_east	true	
legacy_nomadic_waves_of_the_green_sea	sc_rom_barb_east	true	
legacy_nomadic_yurt_burners	sc_rom_barb_east	true	
legacy_parthian_arasaces_armour	sc_rom_parthian	true	
legacy_parthian_black_quivers	sc_rom_parthian	true	
legacy_parthian_fire_celerity_heralds	sc_rom_parthian	true	
legacy_parthian_fire_fires_wrath	sc_rom_parthian	true	
legacy_parthian_fire_purpose_executors	sc_rom_parthian	true	
legacy_parthian_fire_victory_champions	sc_rom_parthian	true	
legacy_parthian_karen_defenders	sc_rom_parthian	true	
legacy_parthian_mithra_truth	sc_rom_parthian	true	
legacy_parthian_parni_children	sc_rom_parthian	true	
legacy_parthian_rostam_companions	sc_rom_parthian	true	
legacy_parthian_surena_champions	sc_rom_parthian	true	
legacy_parthian_verethragna_fury	sc_rom_parthian	true	
legacy_parthian_xerxes_vengeance	sc_rom_parthian	true	
legacy_pontic_persephones_favourites	sc_rom_pontic	true	
legacy_pontic_ravaging_chimeras	sc_rom_pontic	true	
legacy_pontic_sons_of_rhea	sc_rom_pontic	true	
legacy_pontic_the_cyclops_slayers	sc_rom_pontic	true	
legacy_pontus_amasis_champions	sc_rom_pontic	true	
legacy_pontus_amazon_sons	sc_rom_pontic	true	
legacy_pontus_founder_favourite	sc_rom_pontic	true	
legacy_pontus_friends_of_centaurs	sc_rom_pontic	true	
legacy_pontus_hittites	sc_rom_pontic	true	
legacy_pontus_hyperion_sentinels	sc_rom_pontic	true	
legacy_pontus_lykoi	sc_rom_pontic	true	
legacy_pontus_mithridates_chosen	sc_rom_pontic	true	
legacy_pontus_mountain_heroes	sc_rom_pontic	true	
legacy_pontus_servants_of_charon	sc_rom_pontic	true	
legacy_pontus_sinope_scions	sc_rom_pontic	true	
legacy_ptolemaic_bast_pride	sc_rom_egyptian	true	
legacy_ptolemaic_horus_cast	sc_rom_egyptian	true	
legacy_ptolemaic_nile_defenders	sc_rom_egyptian	true	
legacy_ptolemaic_pharaoh_braves	sc_rom_egyptian	true	
legacy_ptolemaic_ptah_justice	sc_rom_egyptian	true	
legacy_ptolemaic_radiant_obelisks	sc_rom_egyptian	true	
legacy_ptolemaic_scarabs_sacred	sc_rom_egyptian	true	
legacy_ptolemaic_sekhmet_pride	sc_rom_egyptian	true	
legacy_ptolemaic_sobek_bask	sc_rom_egyptian	true	
legacy_ptolemaic_sphinx_claws	sc_rom_egyptian	true	
legacy_ptolemaic_two_lands_defenders	sc_rom_egyptian	true	
legacy_ptolemaic_zeus_sons	sc_rom_egyptian	true	
