ancillary	agent
#ancillary_to_included_agents_tables;0;db/ancillary_to_included_agents_tables/ancillary_to_included_agents	
3c_event_sassanian_sculptor	general
dk_foreign_intrigue_advisor	general
inv_brennus_sword	general
inv_dionysius_poetry	general
inv_horned_helmet	general
inv_illyrian_captain	general
inv_illyrian_deckhand	general
inv_illyrian_pirate	general
inv_illyrian_traitor	general
inv_statue_of_baal_hammon	general
inv_statue_of_juno	general
inv_trophy_bear	general
inv_trophy_boar	general
inv_trophy_stag	general
inv_trophy_wolf	general
inv_weighted_scale	general
r2_sp_anc_all_army_hero_berber_raider	general
r2_sp_anc_all_army_hero_berber	general
r2_sp_anc_all_army_hero_saviour	general
r2_sp_anc_all_army_master_armourer	general
r2_sp_anc_all_army_master_beast	general
r2_sp_anc_all_army_master_horse_archer	general
r2_sp_anc_all_army_master_horse_numidian	general
r2_sp_anc_all_army_master_horses	general
r2_sp_anc_all_army_master_hunter_trouble	general
r2_sp_anc_all_army_master_hunter	general
r2_sp_anc_all_army_master_mercenary	general
r2_sp_anc_all_army_master_siege_engineer	general
r2_sp_anc_all_army_master_smith	general
r2_sp_anc_all_army_scout_british_chav	general
r2_sp_anc_all_army_scout_desert_arabian	general
r2_sp_anc_all_army_scout_desert	general
r2_sp_anc_all_army_scout_german	general
r2_sp_anc_all_army_shieldbearer	general
r2_sp_anc_all_army_slaver	general
r2_sp_anc_all_army_steed	general
r2_sp_anc_all_barbarian_pirate	champion
r2_sp_anc_all_barbarian_pirate	dignitary
r2_sp_anc_all_barbarian_pirate	general
r2_sp_anc_all_barbarian_pirate	spy
r2_sp_anc_all_booze_companion	general
r2_sp_anc_all_christian_priest	champion
r2_sp_anc_all_christian_priest	dignitary
r2_sp_anc_all_christian_priest	general
r2_sp_anc_all_christian_priest	spy
r2_sp_anc_all_crisis_manager	champion
r2_sp_anc_all_crisis_manager	dignitary
r2_sp_anc_all_crisis_manager	general
r2_sp_anc_all_crisis_manager	spy
r2_sp_anc_all_east_eunuch_authority	champion
r2_sp_anc_all_east_eunuch_authority	dignitary
r2_sp_anc_all_east_eunuch_authority	general
r2_sp_anc_all_east_eunuch_authority	spy
r2_sp_anc_all_east_eunuch_subterfuge	champion
r2_sp_anc_all_east_eunuch_subterfuge	dignitary
r2_sp_anc_all_east_eunuch_subterfuge	general
r2_sp_anc_all_east_eunuch_subterfuge	spy
r2_sp_anc_all_east_eunuch_zeal	champion
r2_sp_anc_all_east_eunuch_zeal	dignitary
r2_sp_anc_all_east_eunuch_zeal	general
r2_sp_anc_all_east_eunuch_zeal	spy
r2_sp_anc_all_ex_slum_lord	champion
r2_sp_anc_all_ex_slum_lord	dignitary
r2_sp_anc_all_ex_slum_lord	general
r2_sp_anc_all_ex_slum_lord	spy
r2_sp_anc_all_govt_dealer_horse	general
r2_sp_anc_all_govt_goldsmith	dignitary
r2_sp_anc_all_govt_merchant_adventurer	champion
r2_sp_anc_all_govt_money_treasurer	general
r2_sp_anc_all_govt_trader_parthia	champion
r2_sp_anc_all_govt_translator_polite	dignitary
r2_sp_anc_all_house_bard_gallic	general
r2_sp_anc_all_house_healer_quack	general
r2_sp_anc_all_house_honest_man	general
r2_sp_anc_all_house_old_man_1	general
r2_sp_anc_all_house_old_man_2	general
r2_sp_anc_all_house_tutor_latin	general
r2_sp_anc_all_house_tutor	general
r2_sp_anc_all_house_wise_man	general
r2_sp_anc_all_item_armour_cuirass_moon	champion
r2_sp_anc_all_item_army_bow_parthian	general
r2_sp_anc_all_item_disguise_leper	champion
r2_sp_anc_all_item_disguise_leper	dignitary
r2_sp_anc_all_item_disguise_leper	spy
r2_sp_anc_all_item_disguise_vestal	champion
r2_sp_anc_all_item_disguise_vestal	dignitary
r2_sp_anc_all_item_disguise_vestal	spy
r2_sp_anc_all_item_falx	champion
r2_sp_anc_all_item_glasses	general
r2_sp_anc_all_item_shield_practice	champion
r2_sp_anc_all_local_bandit	champion
r2_sp_anc_all_local_bandit	dignitary
r2_sp_anc_all_local_bandit	general
r2_sp_anc_all_local_bandit	spy
r2_sp_anc_all_magic_magician	champion
r2_sp_anc_all_magic_magician	dignitary
r2_sp_anc_all_magic_magician	general
r2_sp_anc_all_magic_magician	spy
r2_sp_anc_all_magic_magus_east	champion
r2_sp_anc_all_magic_magus_east	dignitary
r2_sp_anc_all_magic_magus_east	spy
r2_sp_anc_all_magic_soothsayer_1	general
r2_sp_anc_all_magic_soothsayer_2	general
r2_sp_anc_all_magic_witch_1_medical	champion
r2_sp_anc_all_magic_witch_1_medical	dignitary
r2_sp_anc_all_magic_witch_1_medical	spy
r2_sp_anc_all_magic_witch_3_advisor	champion
r2_sp_anc_all_magic_witch_3_advisor	dignitary
r2_sp_anc_all_magic_witch_3_advisor	spy
r2_sp_anc_all_magic_witch_4_celt	champion
r2_sp_anc_all_magic_witch_4_celt	dignitary
r2_sp_anc_all_magic_witch_4_celt	spy
r2_sp_anc_all_magic_witch_5_killer	champion
r2_sp_anc_all_magic_witch_5_killer	dignitary
r2_sp_anc_all_magic_witch_5_killer	spy
r2_sp_anc_all_magic_witch_6_fake	champion
r2_sp_anc_all_magic_witch_6_fake	dignitary
r2_sp_anc_all_magic_witch_6_fake	spy
r2_sp_anc_all_medic_heal_all	champion
r2_sp_anc_all_medic_heal_all	dignitary
r2_sp_anc_all_medic_heal_all	general
r2_sp_anc_all_medic_heal_all	spy
r2_sp_anc_all_medic_herbalist	champion
r2_sp_anc_all_medic_herbalist	dignitary
r2_sp_anc_all_medic_herbalist	general
r2_sp_anc_all_medic_herbalist	spy
r2_sp_anc_all_misc_who	general
r2_sp_anc_all_mistress_barbarian	general
r2_sp_anc_all_mistress_berber	general
r2_sp_anc_all_mistress_civilized	general
r2_sp_anc_all_mistress_dancer	champion
r2_sp_anc_all_mistress_dancer	dignitary
r2_sp_anc_all_mistress_dancer	spy
r2_sp_anc_all_mistress_floozy	general
r2_sp_anc_all_mistress_skilled	champion
r2_sp_anc_all_mistress_skilled	dignitary
r2_sp_anc_all_mistress_skilled	spy
r2_sp_anc_all_mistress_tart	champion
r2_sp_anc_all_mistress_tart	dignitary
r2_sp_anc_all_mistress_tart	spy
r2_sp_anc_all_navy_fisherman_wise	general
r2_sp_anc_all_navy_master_pilot_1	general
r2_sp_anc_all_navy_master_pilot	general
r2_sp_anc_all_navy_master_seaman	general
r2_sp_anc_all_navy_pirate_reformed	general
r2_sp_anc_all_navy_pirate	general
r2_sp_anc_all_navy_shipwright	general
r2_sp_anc_all_one_eyed_veteran	general
r2_sp_anc_all_pet_bear	champion
r2_sp_anc_all_pet_monkey_escape	champion
r2_sp_anc_all_pet_monkey_escape	dignitary
r2_sp_anc_all_pet_monkey_escape	spy
r2_sp_anc_all_pet_monkey_thief	spy
r2_sp_anc_all_pet_sheep	general
r2_sp_anc_all_pet_snake	champion
r2_sp_anc_all_pet_snake	dignitary
r2_sp_anc_all_pet_snake	spy
r2_sp_anc_all_religion_cultist_secret	champion
r2_sp_anc_all_religion_cultist_secret	dignitary
r2_sp_anc_all_religion_cultist_secret	general
r2_sp_anc_all_religion_cultist_secret	spy
r2_sp_anc_all_religion_prophet_desert_1	champion
r2_sp_anc_all_religion_prophet_desert_2	dignitary
r2_sp_anc_all_religion_prophet_desert_2	general
r2_sp_anc_all_religion_prophet_desert_2	spy
r2_sp_anc_all_religion_secret_dreadful	spy
r2_sp_anc_all_slave_exotic	general
r2_sp_anc_all_slave_girl_barbarian	general
r2_sp_anc_all_spy_mentat_1	champion
r2_sp_anc_all_spy_mentat_1	dignitary
r2_sp_anc_all_spy_mentat_1	spy
r2_sp_anc_all_spy_mentat_2	champion
r2_sp_anc_all_spy_mentat_2	dignitary
r2_sp_anc_all_spy_mentat_2	spy
r2_sp_anc_all_spy_poisoner	dignitary
r2_sp_anc_all_thinker_barbarian	general
r2_sp_anc_all_trade_expert	general
r2_sp_anc_all_traitor_barbarian_barb_iberian	general
r2_sp_anc_all_traitor_barbarian_celt	general
r2_sp_anc_all_traitor_barbarian_gaul	general
r2_sp_anc_all_traitor_barbarian_german	general
r2_sp_anc_all_traitor_briton	general
r2_sp_anc_all_traitor_eastern_generic	general
r2_sp_anc_all_traitor_eastern_parthia	general
r2_sp_anc_all_traitor_egypt	general
r2_sp_anc_all_traitor_greek_macedonia	general
r2_sp_anc_all_traitor_greek	general
r2_sp_anc_all_traitor_punic	general
r2_sp_anc_all_traitor_roman_equestrian	general
r2_sp_anc_all_traitor_roman_exile	general
r2_sp_anc_all_traitor_roman_patrician	general
r2_sp_anc_all_traitor_roman_plebian	general
r2_sp_anc_armenian_religion_vahakan	general
r2_sp_anc_barbarian_ambassador	general
r2_sp_anc_barbarian_army_guard	general
r2_sp_anc_barbarian_army_hero_celt	general
r2_sp_anc_barbarian_army_hero_chris_knight	general
r2_sp_anc_barbarian_army_hero_gian	general
r2_sp_anc_barbarian_army_hero_old	general
r2_sp_anc_barbarian_army_hero_tim	general
r2_sp_anc_barbarian_army_hero_will	general
r2_sp_anc_barbarian_army_swordbearer	general
r2_sp_anc_barbarian_army_sword	general
r2_sp_anc_barbarian_army_warrior_famous	general
r2_sp_anc_barbarian_arts_bard_biographer	general
r2_sp_anc_barbarian_arts_bard	general
r2_sp_anc_barbarian_arts_menhir	general
r2_sp_anc_barbarian_astrologer	general
r2_sp_anc_barbarian_astronomer	general
r2_sp_anc_barbarian_bard	general
r2_sp_anc_barbarian_black_cauldron	general
r2_sp_anc_barbarian_childhood_friend	general
r2_sp_anc_barbarian_govt_scribe	dignitary
r2_sp_anc_barbarian_govt_translator	general
r2_sp_anc_barbarian_hazel_shells	general
r2_sp_anc_barbarian_historian	general
r2_sp_anc_barbarian_house_musician_gallic	general
r2_sp_anc_barbarian_house_musician	general
r2_sp_anc_barbarian_house_old_man	general
r2_sp_anc_barbarian_item_bracelet	champion
r2_sp_anc_barbarian_item_bronze_mirror	general
r2_sp_anc_barbarian_item_chainmail_shirt	champion
r2_sp_anc_barbarian_item_drinking_horn	champion
r2_sp_anc_barbarian_item_excalibur	general
r2_sp_anc_barbarian_item_fish_sauce	general
r2_sp_anc_barbarian_item_god_hearth	general
r2_sp_anc_barbarian_item_heart	general
r2_sp_anc_barbarian_item_horn	general
r2_sp_anc_barbarian_item_limed_head	general
r2_sp_anc_barbarian_item_potion	spy
r2_sp_anc_barbarian_item_skull_cup	champion
r2_sp_anc_barbarian_item_solar_wheel_amulet	champion
r2_sp_anc_barbarian_item_spear_wotan	general
r2_sp_anc_barbarian_item_war_helmet	general
r2_sp_anc_barbarian_jeweller	general
r2_sp_anc_barbarian_kate	general
r2_sp_anc_barbarian_magic_crone	general
r2_sp_anc_barbarian_midwife	general
r2_sp_anc_barbarian_pelt_white_stag	general
r2_sp_anc_barbarian_pet_raven	general
r2_sp_anc_barbarian_playwright_1	dignitary
r2_sp_anc_barbarian_playwright_2	dignitary
r2_sp_anc_barbarian_poet	general
r2_sp_anc_barbarian_religion_britannia	general
r2_sp_anc_barbarian_religion_druid_shaman	general
r2_sp_anc_barbarian_religion_mabon	general
r2_sp_anc_barbarian_religion_shaman	general
r2_sp_anc_barbarian_religion_taranis	champion
r2_sp_anc_barbarian_religion_wise_salmon	general
r2_sp_anc_barbarian_road_builder	general
r2_sp_anc_barbarian_sheep	general
r2_sp_anc_barbarian_storyteller	general
r2_sp_anc_briton_army_hero_young_irish	general
r2_sp_anc_briton_army_trumpet_irish	general
r2_sp_anc_briton_army_young_warrior_2	general
r2_sp_anc_briton_champion	general
r2_sp_anc_briton_judge_irish	general
r2_sp_anc_briton_religion_belenus	general
r2_sp_anc_briton_religion_druid_1	general
r2_sp_anc_briton_religion_druid_2	general
r2_sp_anc_celtic_army_trumpet	general
r2_sp_anc_celtic_army_young_warrior	general
r2_sp_anc_civilised_army_baldrick	general
r2_sp_anc_civilised_army_brigand	general
r2_sp_anc_civilised_army_diarist	general
r2_sp_anc_civilised_army_explorer	champion
r2_sp_anc_civilised_army_hero	general
r2_sp_anc_civilised_army_inventor_2	general
r2_sp_anc_civilised_army_inventor	general
r2_sp_anc_civilised_army_master_artillery	general
r2_sp_anc_civilised_army_master_drill	general
r2_sp_anc_civilised_army_master_engineer	general
r2_sp_anc_civilised_army_messenger_galloper	general
r2_sp_anc_civilised_army_messenger_runner	general
r2_sp_anc_civilised_army_quartermaster	general
r2_sp_anc_civilised_army_warrior_veteran	general
r2_sp_anc_civilised_arts_biographer	general
r2_sp_anc_civilised_arts_comedian	general
r2_sp_anc_civilised_arts_historian	general
r2_sp_anc_civilised_arts_jeweller	general
r2_sp_anc_civilised_arts_librarian	general
r2_sp_anc_civilised_arts_playwright	general
r2_sp_anc_civilised_arts_satire	general
r2_sp_anc_civilised_booze_merchant	general
r2_sp_anc_civilised_glassblower	general
r2_sp_anc_civilised_govt_build_architect	general
r2_sp_anc_civilised_govt_build_mason	general
r2_sp_anc_civilised_govt_build_roads	general
r2_sp_anc_civilised_govt_build_surveyor	general
r2_sp_anc_civilised_govt_coin_expert	general
r2_sp_anc_civilised_govt_engineer_mining	general
r2_sp_anc_civilised_govt_engineer_water	general
r2_sp_anc_civilised_govt_farmer	general
r2_sp_anc_civilised_govt_foreigner	general
r2_sp_anc_civilised_govt_inventor	general
r2_sp_anc_civilised_govt_judge_bent_2	general
r2_sp_anc_civilised_govt_judge_bent	general
r2_sp_anc_civilised_govt_judge_honest	general
r2_sp_anc_civilised_govt_judge_magistrate_evil	general
r2_sp_anc_civilised_govt_judge_magistrate	general
r2_sp_anc_civilised_govt_mapmaker	general
r2_sp_anc_civilised_govt_mine_overseer	general
r2_sp_anc_civilised_govt_money_idiot	general
r2_sp_anc_civilised_govt_money_mathematician	general
r2_sp_anc_civilised_govt_money_tax_farmer	general
r2_sp_anc_civilised_govt_orator	general
r2_sp_anc_civilised_govt_scribe_east	general
r2_sp_anc_civilised_govt_scribe_egypt	general
r2_sp_anc_civilised_govt_scribe_greek	general
r2_sp_anc_civilised_govt_scribe_roman	general
r2_sp_anc_civilised_govt_shipping_magnate	general
r2_sp_anc_civilised_govt_spymaster	general
r2_sp_anc_civilised_govt_surveyor_land	general
r2_sp_anc_civilised_govt_trader_grain	general
r2_sp_anc_civilised_govt_trader_greek	general
r2_sp_anc_civilised_govt_translator	dignitary
r2_sp_anc_civilised_house_athlete	general
r2_sp_anc_civilised_house_clerk_freeman	general
r2_sp_anc_civilised_house_foodtaster	general
r2_sp_anc_civilised_house_giant_german	general
r2_sp_anc_civilised_house_guard_wrestler	general
r2_sp_anc_civilised_house_mentor_greek	general
r2_sp_anc_civilised_house_musician	general
r2_sp_anc_civilised_house_wine_steward	general
r2_sp_anc_civilised_infamous_atheist	general
r2_sp_anc_civilised_item_fossil_dinosaur	general
r2_sp_anc_civilised_item_fossil_mammoth	general
r2_sp_anc_civilised_item_lens_medical	general
r2_sp_anc_civilised_item_lens	general
r2_sp_anc_civilised_item_notepad	general
r2_sp_anc_civilised_item_poison_hemlock_2	general
r2_sp_anc_civilised_magic_astrologer_2	general
r2_sp_anc_civilised_magic_astrologer_3	general
r2_sp_anc_civilised_medic_surgeon	general
r2_sp_anc_civilised_mistress_courtesan_top	spy
r2_sp_anc_civilised_mistress_courtesan	spy
r2_sp_anc_civilised_navy_pirate_cilician_reformed	general
r2_sp_anc_civilised_navy_pirate_cilician	general
r2_sp_anc_civilised_navy_sponge_diver	general
r2_sp_anc_civilised_navy_surgeon	general
r2_sp_anc_civilised_pet_hostage	general
r2_sp_anc_civilised_pet_idiot	general
r2_sp_anc_civilised_philosopher_rhetoric	general
r2_sp_anc_civilised_slave_body_1	general
r2_sp_anc_civilised_slave_body_2	general
r2_sp_anc_civilised_slave_bodyguard	general
r2_sp_anc_civilised_spy_lady_killer	champion
r2_sp_anc_civilised_spy_lady_killer	dignitary
r2_sp_anc_civilised_spy_lady_killer	spy
r2_sp_anc_civilised_thinker_cynic	general
r2_sp_anc_civilised_thinker_natural_philosopher	general
r2_sp_anc_civilised_thinker_platonic	general
r2_sp_anc_civilised_thinker_rubbish	general
r2_sp_anc_civilised_thinker_socratic	general
r2_sp_anc_civilised_thinker_stoic	general
r2_sp_anc_civilised_traitor_barbarian_generic	general
r2_sp_anc_dacian_army_standard	general
r2_sp_anc_dacian_religion_zalmoxis	general
r2_sp_anc_east_lizard_god_cultist	general
r2_sp_anc_east_medicineman_civilresearch	general
r2_sp_anc_east_medicineman_replenishmentrate	general
r2_sp_anc_east_medicineman_sanitation	general
r2_sp_anc_eastern_army_armour_arm_bands	general
r2_sp_anc_eastern_army_cataphract	general
r2_sp_anc_eastern_army_dahae_tribesman	general
r2_sp_anc_eastern_army_elamite_archer	general
r2_sp_anc_eastern_army_massagetae_tribesman	general
r2_sp_anc_eastern_army_master_archer	general
r2_sp_anc_eastern_army_master_horse	general
r2_sp_anc_eastern_army_saka_tribesman	general
r2_sp_anc_eastern_army_sword_1	champion
r2_sp_anc_eastern_army_sword_2	champion
r2_sp_anc_eastern_army_temple_guard	general
r2_sp_anc_eastern_chinese_delegate	general
r2_sp_anc_eastern_eastern_stunner_2	general
r2_sp_anc_eastern_govt_dealer_camel	general
r2_sp_anc_eastern_govt_herald	general
r2_sp_anc_eastern_govt_office_bodyguard	general
r2_sp_anc_eastern_govt_office_friend	general
r2_sp_anc_eastern_govt_office_treasurer	general
r2_sp_anc_eastern_govt_royal_bum	general
r2_sp_anc_eastern_house_guard_eunuch	general
r2_sp_anc_eastern_item_dead_guy_2	general
r2_sp_anc_eastern_item_dead_guy	general
r2_sp_anc_eastern_item_headband	general
r2_sp_anc_eastern_item_magic_carpet	champion
r2_sp_anc_eastern_item_magic_carpet	spy
r2_sp_anc_eastern_item_royal_cap	general
r2_sp_anc_eastern_item_royal_tiara	general
r2_sp_anc_eastern_item_stool_prisoner	general
r2_sp_anc_eastern_item_zoroastrian_bundle	general
r2_sp_anc_eastern_item_zoroastrian_mace	general
r2_sp_anc_eastern_leather_scribe	general
r2_sp_anc_eastern_magic_geomancer	general
r2_sp_anc_eastern_minstrel	general
r2_sp_anc_eastern_pet_cat	general
r2_sp_anc_eastern_philosopher_mystic	general
r2_sp_anc_eastern_religion_anahit	general
r2_sp_anc_eastern_religion_armazd	general
r2_sp_anc_eastern_religion_bel	general
r2_sp_anc_eastern_religion_zoroastra	general
r2_sp_anc_eastern_slave_eunuch	general
r2_sp_anc_eastern_torturer_1	general
r2_sp_anc_eastern_torturer_2	general
r2_sp_anc_egyptian_army_sword	general
r2_sp_anc_egyptian_arts_poet_egypt	general
r2_sp_anc_egyptian_barbarian_bodyguard	general
r2_sp_anc_egyptian_chantress	general
r2_sp_anc_egyptian_customs_agent	general
r2_sp_anc_egyptian_dancing_girl	general
r2_sp_anc_egyptian_doctor	champion
r2_sp_anc_egyptian_doctor	dignitary
r2_sp_anc_egyptian_doctor	general
r2_sp_anc_egyptian_doctor	spy
r2_sp_anc_egyptian_eastern_butler	general
r2_sp_anc_egyptian_eastern_slave	general
r2_sp_anc_egyptian_goldsmith	general
r2_sp_anc_egyptian_greek_veteran	general
r2_sp_anc_egyptian_harpist	general
r2_sp_anc_egyptian_item_amulet_ankh	general
r2_sp_anc_egyptian_item_amulet_phallic	general
r2_sp_anc_egyptian_item_amulet_scarab	general
r2_sp_anc_egyptian_item_amulet_serket	champion
r2_sp_anc_egyptian_item_amulet_serket	dignitary
r2_sp_anc_egyptian_item_amulet_serket	general
r2_sp_anc_egyptian_item_amulet_serket	spy
r2_sp_anc_egyptian_item_amulet_udjat	general
r2_sp_anc_egyptian_item_game_board_1	general
r2_sp_anc_egyptian_item_game_board_2	general
r2_sp_anc_egyptian_item_god_isis	champion
r2_sp_anc_egyptian_item_god_isis	dignitary
r2_sp_anc_egyptian_item_god_isis	general
r2_sp_anc_egyptian_item_god_isis	spy
r2_sp_anc_egyptian_item_grave_servant	champion
r2_sp_anc_egyptian_item_grave_servant	dignitary
r2_sp_anc_egyptian_item_grave_servant	general
r2_sp_anc_egyptian_item_grave_servant	spy
r2_sp_anc_egyptian_item_pharaoh_blue_crown	general
r2_sp_anc_egyptian_item_pharaoh_double_crown	general
r2_sp_anc_egyptian_item_pharaoh_false_beard	general
r2_sp_anc_egyptian_item_pharaoh_nemes	general
r2_sp_anc_egyptian_item_pharaoh_staff	general
r2_sp_anc_egyptian_item_pharaoh_white	general
r2_sp_anc_egyptian_item_pharaoh_wig	general
r2_sp_anc_egyptian_jeweller	general
r2_sp_anc_egyptian_magic_embalmer	general
r2_sp_anc_egyptian_religion_bastet	champion
r2_sp_anc_egyptian_religion_bastet	dignitary
r2_sp_anc_egyptian_religion_bastet	general
r2_sp_anc_egyptian_religion_bastet	spy
r2_sp_anc_egyptian_religion_horus_2	general
r2_sp_anc_egyptian_religion_horus	general
r2_sp_anc_egyptian_religion_imhotep	general
r2_sp_anc_egyptian_religion_isis	general
r2_sp_anc_egyptian_religion_osiris	general
r2_sp_anc_egyptian_religion_set	general
r2_sp_anc_egyptian_scrollmaker	general
r2_sp_anc_egyptian_wrestler	champion
r2_sp_anc_garamantian_bodyguard	dignitary
r2_sp_anc_gaul_briton_religion_teutatis	general
r2_sp_anc_gaul_religion_abnoba	general
r2_sp_anc_gaul_religion_brigantia	general
r2_sp_anc_gaul_religion_druid	general
r2_sp_anc_gaul_religion_epona	general
r2_sp_anc_gaul_religion_esus	general
r2_sp_anc_gaul_religion_moulinex	general
r2_sp_anc_gaul_religion_rosmerta	general
r2_sp_anc_german_army_hero	general
r2_sp_anc_german_army_master_axe	general
r2_sp_anc_german_item_god_donar	champion
r2_sp_anc_german_item_god_woden	champion
r2_sp_anc_german_religion_donar	general
r2_sp_anc_german_religion_woden	general
r2_sp_anc_greek_army_armour_helmet_1	general
r2_sp_anc_greek_army_armour_helmet_2	general
r2_sp_anc_greek_army_armour_helmet_3	general
r2_sp_anc_greek_army_armour_helmet_4	general
r2_sp_anc_greek_army_baggage_slave	general
r2_sp_anc_greek_army_bodyguard	general
r2_sp_anc_greek_army_hero_companion	general
r2_sp_anc_greek_army_hero_hoplite	general
r2_sp_anc_greek_army_master_hoplite	general
r2_sp_anc_greek_army_master_slinger_rhodes	general
r2_sp_anc_greek_army_shield_1	general
r2_sp_anc_greek_army_shield_2	general
r2_sp_anc_greek_army_shield_thrower	general
r2_sp_anc_greek_army_spear_1	general
r2_sp_anc_greek_army_spear_2	general
r2_sp_anc_greek_army_sword_1	general
r2_sp_anc_greek_army_sword_2	general
r2_sp_anc_greek_army_trumpet	general
r2_sp_anc_greek_army_young_hoplite	general
r2_sp_anc_greek_arts_actor_chorus	general
r2_sp_anc_greek_arts_actor	general
r2_sp_anc_greek_arts_poet_epic	general
r2_sp_anc_greek_boxer_bodyguard	dignitary
r2_sp_anc_greek_corrupt_coin_forger	general
r2_sp_anc_greek_corrupt_election_rigger	general
r2_sp_anc_greek_eastern_army_fugitive_general	general
r2_sp_anc_greek_eastern_drug_book	general
r2_sp_anc_greek_eastern_religion_cybele	general
r2_sp_anc_greek_eastern_religion_moon_god	general
r2_sp_anc_greek_eastern_religion_sun_god	general
r2_sp_anc_greek_fish_loony	general
r2_sp_anc_greek_games_boxer	dignitary
r2_sp_anc_greek_gym_instructor	general
r2_sp_anc_greek_harpist	general
r2_sp_anc_greek_herm_carver	general
r2_sp_anc_greek_honest_clerk	general
r2_sp_anc_greek_honest_coin_tester	general
r2_sp_anc_greek_honest_legislator	general
r2_sp_anc_greek_item_boots	general
r2_sp_anc_greek_item_boxing_glove	champion
r2_sp_anc_greek_item_curse_tablet	spy
r2_sp_anc_greek_item_drinking_horn_sparta	champion
r2_sp_anc_greek_item_drinking_horn_sparta	spy
r2_sp_anc_greek_item_drinking_horn_thrace	general
r2_sp_anc_greek_item_god_ares	champion
r2_sp_anc_greek_item_god_dionysus	general
r2_sp_anc_greek_item_god_hephaestus	general
r2_sp_anc_greek_item_graven_image	general
r2_sp_anc_greek_item_parasol	dignitary
r2_sp_anc_greek_item_poison_hemlock_1	champion
r2_sp_anc_greek_item_poison_hemlock_1	dignitary
r2_sp_anc_greek_item_poison_hemlock_1	spy
r2_sp_anc_greek_item_sandals	champion
r2_sp_anc_greek_item_sandals	spy
r2_sp_anc_greek_item_sunhat_1	general
r2_sp_anc_greek_item_sunhat_2	champion
r2_sp_anc_greek_item_sunhat_2	general
r2_sp_anc_greek_item_sunhat_2	spy
r2_sp_anc_greek_item_sword_alexander	general
r2_sp_anc_greek_item_wine_bowl	general
r2_sp_anc_greek_item_wine_cup	general
r2_sp_anc_greek_item_wine_jar	general
r2_sp_anc_greek_magic_oracle	champion
r2_sp_anc_greek_magic_oracle	dignitary
r2_sp_anc_greek_magic_oracle	spy
r2_sp_anc_greek_money_changer	general
r2_sp_anc_greek_mysteries_adept	general
r2_sp_anc_greek_mysteries_initiate_1	general
r2_sp_anc_greek_mysteries_initiate_2	general
r2_sp_anc_greek_mysteries_temple_leader	general
r2_sp_anc_greek_mysteries_virgin_athena	general
r2_sp_anc_greek_philosopher_teacher	general
r2_sp_anc_greek_producer_1	general
r2_sp_anc_greek_producer_2	general
r2_sp_anc_greek_racist_advisor	general
r2_sp_anc_greek_religion_aphrodite	general
r2_sp_anc_greek_religion_ares	general
r2_sp_anc_greek_religion_artemis	general
r2_sp_anc_greek_religion_asklepios	champion
r2_sp_anc_greek_religion_asklepios	dignitary
r2_sp_anc_greek_religion_asklepios	spy
r2_sp_anc_greek_religion_athena	general
r2_sp_anc_greek_religion_demeter	general
r2_sp_anc_greek_religion_dionysus	general
r2_sp_anc_greek_religion_hephaestus	champion
r2_sp_anc_greek_religion_hercules	champion
r2_sp_anc_greek_religion_hermes_1	general
r2_sp_anc_greek_religion_hermes_2	general
r2_sp_anc_greek_religion_nike	general
r2_sp_anc_greek_religion_poseidon	general
r2_sp_anc_greek_religion_zeus	general
r2_sp_anc_greek_shieldmaker	general
r2_sp_anc_greek_sycophant	general
r2_sp_anc_iberian_army_sword	champion
r2_sp_anc_iberian_army_sword	general
r2_sp_anc_non_greek_slave_greek	general
r2_sp_anc_pontic_antidotes	general
r2_sp_anc_punic_african_slave	general
r2_sp_anc_punic_african_spy	general
r2_sp_anc_punic_architect	general
r2_sp_anc_punic_army_barbarian_guide	general
r2_sp_anc_punic_army_defeatist	general
r2_sp_anc_punic_army_libyan_groom	general
r2_sp_anc_punic_coinmaker	dignitary
r2_sp_anc_punic_coinmaker	general
r2_sp_anc_punic_elder_council_member_martin	dignitary
r2_sp_anc_punic_elder_council_member_martin	general
r2_sp_anc_punic_emissary	general
r2_sp_anc_punic_executioner	general
r2_sp_anc_punic_greek_army_elephant_rider	general
r2_sp_anc_punic_greek_army_elephant_spike	general
r2_sp_anc_punic_greek_eastern_army_elephant_comman	general
r2_sp_anc_punic_hannibal_companions_surus	general
r2_sp_anc_punic_item_animal_skin	general
r2_sp_anc_punic_item_fancy_mask	spy
r2_sp_anc_punic_item_god_baal	general
r2_sp_anc_punic_item_god_tanit	general
r2_sp_anc_punic_item_ivory_bowl	general
r2_sp_anc_punic_item_lovely_carpet	champion
r2_sp_anc_punic_item_lovely_carpet	dignitary
r2_sp_anc_punic_item_lovely_carpet	spy
r2_sp_anc_punic_item_perfume_burner	general
r2_sp_anc_punic_item_sacred_stone	general
r2_sp_anc_punic_item_sardinian_lamp	dignitary
r2_sp_anc_punic_item_wig	spy
r2_sp_anc_punic_judge	general
r2_sp_anc_punic_masked_mincer	spy
r2_sp_anc_punic_mercenary_gallic	general
r2_sp_anc_punic_mercenary_greek	general
r2_sp_anc_punic_mercenary_iberian	general
r2_sp_anc_punic_mercenary_italian	general
r2_sp_anc_punic_merchant_italian	dignitary
r2_sp_anc_punic_merchant_italian	general
r2_sp_anc_punic_merchant_libyan_garlic	dignitary
r2_sp_anc_punic_merchant_libyan_garlic	general
r2_sp_anc_punic_merchant_libyan_glass	dignitary
r2_sp_anc_punic_merchant_libyan_glass	general
r2_sp_anc_punic_merchant_sardinian	dignitary
r2_sp_anc_punic_merchant_sardinian	general
r2_sp_anc_punic_merchant_sicilian	dignitary
r2_sp_anc_punic_merchant_sicilian	general
r2_sp_anc_punic_metallurgist	general
r2_sp_anc_punic_numidian_chef	general
r2_sp_anc_punic_propagandist	general
r2_sp_anc_punic_religion_acolyte	general
r2_sp_anc_punic_religion_astarte	general
r2_sp_anc_punic_religion_baal_hammon	general
r2_sp_anc_punic_religion_baal_lucan	general
r2_sp_anc_punic_religion_eshmoun	general
r2_sp_anc_punic_religion_gareth	general
r2_sp_anc_punic_religion_milqart	general
r2_sp_anc_punic_religion_tanit	general
r2_sp_anc_roman_army_armour_1	general
r2_sp_anc_roman_army_armour_2	general
r2_sp_anc_roman_army_armour_3	general
r2_sp_anc_roman_army_artilleryman	general
r2_sp_anc_roman_army_barley_ration	general
r2_sp_anc_roman_army_cadet	general
r2_sp_anc_roman_army_camp_prefect	general
r2_sp_anc_roman_army_cape	general
r2_sp_anc_roman_army_carrier_pigeon	general
r2_sp_anc_roman_army_centurion_primus	general
r2_sp_anc_roman_army_common_prozzy	general
r2_sp_anc_roman_army_dagger	champion
r2_sp_anc_roman_army_dagger	dignitary
r2_sp_anc_roman_army_dagger	spy
r2_sp_anc_roman_army_hero_auxiliary	general
r2_sp_anc_roman_army_hero_hastatus	general
r2_sp_anc_roman_army_hero_principes	general
r2_sp_anc_roman_army_hero_triarius	general
r2_sp_anc_roman_army_hero_velite	general
r2_sp_anc_roman_army_javelin_legionary_early	general
r2_sp_anc_roman_army_javelin_velite	general
r2_sp_anc_roman_army_legionary_guard_captain	general
r2_sp_anc_roman_army_legionary_senior	general
r2_sp_anc_roman_army_legionary_skilled	general
r2_sp_anc_roman_army_lucius_vorinus	general
r2_sp_anc_roman_army_optio	general
r2_sp_anc_roman_army_praetorian	general
r2_sp_anc_roman_army_scout	general
r2_sp_anc_roman_army_shield_1	general
r2_sp_anc_roman_army_shield_2	general
r2_sp_anc_roman_army_sling_and_shot	general
r2_sp_anc_roman_army_slinger	general
r2_sp_anc_roman_army_spear_1	general
r2_sp_anc_roman_army_standard_bearer	general
r2_sp_anc_roman_army_standard_eagle	general
r2_sp_anc_roman_army_sword_1	general
r2_sp_anc_roman_army_titus_pullo	general
r2_sp_anc_roman_army_tribune	general
r2_sp_anc_roman_army_trumpeter_veteran	general
r2_sp_anc_roman_army_veteran_centurion	general
r2_sp_anc_roman_army_watch_goose	general
r2_sp_anc_roman_arts_actor	general
r2_sp_anc_roman_arts_comedian	general
r2_sp_anc_roman_arts_poet_ode	general
r2_sp_anc_roman_civil_publican	general
r2_sp_anc_roman_client_equestrian_1	general
r2_sp_anc_roman_client_equestrian_2	general
r2_sp_anc_roman_client_freeman	general
r2_sp_anc_roman_client_lanista	general
r2_sp_anc_roman_client_magistrate	general
r2_sp_anc_roman_client_mobster	general
r2_sp_anc_roman_client_plebian_1	general
r2_sp_anc_roman_client_plebian_2	general
r2_sp_anc_roman_client_senator	general
r2_sp_anc_roman_crocodile_wrestler	champion
r2_sp_anc_roman_crocodile_wrestler	dignitary
r2_sp_anc_roman_crocodile_wrestler	spy
r2_sp_anc_roman_eyeliner	general
r2_sp_anc_roman_games_animal	general
r2_sp_anc_roman_games_boxer	general
r2_sp_anc_roman_games_charioteer_blue	general
r2_sp_anc_roman_games_charioteer_green	general
r2_sp_anc_roman_games_charioteer_red	general
r2_sp_anc_roman_games_charioteer_white	general
r2_sp_anc_roman_games_doctore	general
r2_sp_anc_roman_games_editor	general
r2_sp_anc_roman_games_lanista	general
r2_sp_anc_roman_games_murmillo	general
r2_sp_anc_roman_games_primus_palus	general
r2_sp_anc_roman_games_provocator	general
r2_sp_anc_roman_games_rudiarius	general
r2_sp_anc_roman_games_sagittarius	general
r2_sp_anc_roman_games_secutor	general
r2_sp_anc_roman_games_thracian	general
r2_sp_anc_roman_govt_dealer_animal	general
r2_sp_anc_roman_govt_executioner_1	general
r2_sp_anc_roman_govt_executioner_2	general
r2_sp_anc_roman_govt_executioner_3	general
r2_sp_anc_roman_govt_heckler	general
r2_sp_anc_roman_govt_judge_carnifex	general
r2_sp_anc_roman_govt_judge_lictor	general
r2_sp_anc_roman_govt_lawyer	general
r2_sp_anc_roman_govt_orator	general
r2_sp_anc_roman_govt_senator_old	general
r2_sp_anc_roman_govt_senator	general
r2_sp_anc_roman_govt_tribune_pleb	general
r2_sp_anc_roman_govt_vestal	general
r2_sp_anc_roman_house_briton	general
r2_sp_anc_roman_house_dog_guard	champion
r2_sp_anc_roman_house_dog_guard	dignitary
r2_sp_anc_roman_house_dog_guard	spy
r2_sp_anc_roman_house_dog_harsh	general
r2_sp_anc_roman_house_glutton	general
r2_sp_anc_roman_insane_cultist	general
r2_sp_anc_roman_insult_monger	general
r2_sp_anc_roman_item_barbarian_breeches	general
r2_sp_anc_roman_item_barbarian_cloak_hooded	general
r2_sp_anc_roman_item_barbarian_cloak	general
r2_sp_anc_roman_item_centurion_rod	general
r2_sp_anc_roman_item_dice	general
r2_sp_anc_roman_item_family_shrine	general
r2_sp_anc_roman_item_god_bacchus	general
r2_sp_anc_roman_item_god_bellona	general
r2_sp_anc_roman_item_god_ceres	general
r2_sp_anc_roman_item_god_jupiter	general
r2_sp_anc_roman_item_god_mars	general
r2_sp_anc_roman_item_god_mithras	general
r2_sp_anc_roman_item_god_neptune	general
r2_sp_anc_roman_item_god_vulcan	general
r2_sp_anc_roman_item_judge_fasces	general
r2_sp_anc_roman_item_lead_curse	spy
r2_sp_anc_roman_item_magic_nail	champion
r2_sp_anc_roman_item_medical_kit	general
r2_sp_anc_roman_item_mess_tin	general
r2_sp_anc_roman_item_pelt_wolf	general
r2_sp_anc_roman_item_scourge	general
r2_sp_anc_roman_item_spade	general
r2_sp_anc_roman_item_sword_mars	general
r2_sp_anc_roman_item_sword_practice	general
r2_sp_anc_roman_justice_procurator	general
r2_sp_anc_roman_lizard_cultist	general
r2_sp_anc_roman_magic_ghost_bad	general
r2_sp_anc_roman_magic_ghost_good	general
r2_sp_anc_roman_magic_ghost_neutral	general
r2_sp_anc_roman_magic_haruspex	general
r2_sp_anc_roman_medic_medicus_1	general
r2_sp_anc_roman_medic_medicus_2	general
r2_sp_anc_roman_military_diploma	general
r2_sp_anc_roman_navy_marine	general
r2_sp_anc_roman_pet_lion	general
r2_sp_anc_roman_pet_tortoise	general
r2_sp_anc_roman_philosopher_teacher	general
r2_sp_anc_roman_religion_bacchus	general
r2_sp_anc_roman_religion_bellona	general
r2_sp_anc_roman_religion_ceres_rome	general
r2_sp_anc_roman_religion_cybele	general
r2_sp_anc_roman_religion_epona_late	general
r2_sp_anc_roman_religion_hercules	champion
r2_sp_anc_roman_religion_juno	general
r2_sp_anc_roman_religion_jupiter_1	general
r2_sp_anc_roman_religion_jupiter_2	general
r2_sp_anc_roman_religion_mars	general
r2_sp_anc_roman_religion_mercury	general
r2_sp_anc_roman_religion_neptune	general
r2_sp_anc_roman_religion_pontifex	general
r2_sp_anc_roman_religion_saturn	general
r2_sp_anc_roman_religion_victoria	general
r2_sp_anc_roman_religion_vulcan	general
r2_sp_anc_roman_slave_debtor	general
r2_sp_anc_roman_snitch	general
r2_sp_anc_roman_trade_plebian	general
r2_sp_anc_roman_trade_posh	general
r2_sp_anc_roman_winemaker_culturespread_gdpentertainment	champion
r2_sp_anc_roman_winemaker_culturespread_gdpentertainment	dignitary
r2_sp_anc_roman_winemaker_culturespread_gdpentertainment	general
r2_sp_anc_roman_winemaker_culturespread_gdpentertainment	spy
r2_sp_anc_roman_winemaker_growth_gdpentertainment	champion
r2_sp_anc_roman_winemaker_growth_gdpentertainment	dignitary
r2_sp_anc_roman_winemaker_growth_gdpentertainment	general
r2_sp_anc_roman_winemaker_growth_gdpentertainment	spy
r2_sp_anc_roman_winemaker_slaveunrest_culturespread	champion
r2_sp_anc_roman_winemaker_slaveunrest_culturespread	dignitary
r2_sp_anc_roman_winemaker_slaveunrest_culturespread	general
r2_sp_anc_roman_winemaker_slaveunrest_culturespread	spy
r2_sp_anc_roman_winemaker_slaveunrest_growth	champion
r2_sp_anc_roman_winemaker_slaveunrest_growth	dignitary
r2_sp_anc_roman_winemaker_slaveunrest_growth	general
r2_sp_anc_roman_winemaker_slaveunrest_growth	spy
r2_sp_anc_scythian_army_dagger	champion
r2_sp_anc_scythian_army_dagger	dignitary
r2_sp_anc_scythian_army_dagger	general
r2_sp_anc_scythian_army_dagger	spy
r2_sp_anc_scythian_army_lance	general
r2_sp_anc_scythian_blacksmith	general
r2_sp_anc_scythian_coin_mint	dignitary
r2_sp_anc_scythian_coin_mint	general
r2_sp_anc_scythian_eunuch	general
r2_sp_anc_scythian_item_drinking_horn	general
r2_sp_anc_scythian_item_gold_amulet	champion
r2_sp_anc_scythian_item_gold_amulet	dignitary
r2_sp_anc_scythian_item_gold_amulet	general
r2_sp_anc_scythian_item_gold_amulet	spy
r2_sp_anc_scythian_item_gold_brooch	champion
r2_sp_anc_scythian_item_gold_brooch	dignitary
r2_sp_anc_scythian_item_gold_brooch	general
r2_sp_anc_scythian_item_gold_brooch	spy
r2_sp_anc_scythian_item_gold_buckle	champion
r2_sp_anc_scythian_item_gold_buckle	dignitary
r2_sp_anc_scythian_item_gold_buckle	general
r2_sp_anc_scythian_item_gold_buckle	spy
r2_sp_anc_scythian_item_severed_head	general
r2_sp_anc_scythian_metallurgist	general
r2_sp_anc_scythian_mystic	dignitary
r2_sp_anc_scythian_mystic	general
r2_sp_anc_scythian_old_man	general
r2_sp_anc_scythian_trader_cattle	dignitary
r2_sp_anc_scythian_trader_cattle	general
r2_sp_anc_scythian_trader_grain	dignitary
r2_sp_anc_scythian_trader_grain	general
r2_sp_anc_scythian_trader_skins	dignitary
r2_sp_anc_scythian_trader_skins	general
r2_sp_anc_scythian_trader_slaves	dignitary
r2_sp_anc_scythian_trader_slaves	general
r2_sp_anc_seleucid_eastern_army_elephant_expert	general
r2_sp_anc_silly_banacaces	champion
r2_sp_anc_silly_banacaces	dignitary
r2_sp_anc_silly_banacaces	spy
r2_sp_anc_silly_banacix	champion
r2_sp_anc_silly_banacix	dignitary
r2_sp_anc_silly_banacix	spy
r2_sp_anc_silly_banacus	champion
r2_sp_anc_silly_banacus	dignitary
r2_sp_anc_silly_banacus	spy
r2_sp_anc_silly_banakon	champion
r2_sp_anc_silly_banakon	dignitary
r2_sp_anc_silly_banakon	spy
r2_sp_anc_silly_banaqart	champion
r2_sp_anc_silly_banaqart	dignitary
r2_sp_anc_silly_banaqart	spy
r2_sp_anc_silly_time_tunnel_1	general
r2_sp_anc_silly_time_tunnel_2	general
r2_sp_anc_thracian_army_club	champion
r2_sp_anc_thracian_army_shield	general
r2_sp_anc_thracian_army_spear	general
r2_sp_anc_thracian_army_sword	general
r2_sp_anc_thracian_item_cap	champion
r2_sp_anc_thracian_item_cloak	general
r2_sp_anc_thracian_religion_bendis	general
r2_sp_anc_thracian_religion_darzalas	general
r2_sp_anc_thracian_religion_hebeleysis	general
rr2_sp_anc_barbarian_priest	general
