key	texture_directory	building_category
#warscape_rigid_tables;2;db/warscape_rigid_tables/warscape_rigid		
10m_block_piece01_destruct01	rigidmodels/buildings/textures	battle_building
20m_block_piece01_destruct01	rigidmodels/buildings/textures	battle_building
3_pillars_piece01_destruct01	rigidmodels/buildings/textures	battle_building
45m_block_piece01_destruct01	rigidmodels/buildings/textures	battle_building
ALL_army_dug_in	RigidModels/CampaignBuildings/CampaignProps/Textures	campaign_template_extra
ALL_army_no_movement_points	RigidModels/CampaignBuildings/CampaignProps/Textures	campaign_template_extra
ALL_port_construction	RigidModels/CampaignBuildings/CampaignProps/Textures	campaign_template_extra
Ep1_city_farm_corn	RigidModels/CampaignBuildings/Jamestown/Textures	campaign_building
Ep1_city_plantation_cotton	RigidModels/CampaignBuildings/Jamestown/Textures	campaign_building
Ep1_city_plantation_tobacco	RigidModels/CampaignBuildings/Jamestown/Textures	campaign_building
Ep1_port_fishery	RigidModels/CampaignBuildings/Jamestown/Textures	campaign_building
Fort_lvl1	RigidModels/CampaignBuildings/Textures	campaign_fort
Fort_lvl2	RigidModels/CampaignBuildings/Textures	campaign_fort
Fort_lvl3	RigidModels/CampaignBuildings/Textures	campaign_fort
JT_city_1_slot	RigidModels/CampaignBuildings/Jamestown/Textures	campaign_template_extra
JT_city_1_slot_buildings	RigidModels/CampaignBuildings/Jamestown/Textures	campaign_template_extra
JT_city_1_slot_fortifications_lvl0	RigidModels/CampaignBuildings/Jamestown/Textures	campaign_template_extra
JT_city_1_slot_together	RigidModels/CampaignBuildings/Jamestown/Textures	campaign_template_extra
Prestige_Arcdetriomphe	RigidModels/CampaignBuildings/Textures	campaign_building
Prestige_NavalEngineer	RigidModels/CampaignBuildings/Textures	campaign_building
Prestige_Rogalinpalace	RigidModels/CampaignBuildings/Textures	campaign_building
Prestige_berlinacademy	RigidModels/CampaignBuildings/Textures	campaign_building
Prestige_blenheimpalace	RigidModels/CampaignBuildings/Textures	campaign_building
Prestige_bourbon	RigidModels/CampaignBuildings/Textures	campaign_building
Prestige_brandenburg	RigidModels/CampaignBuildings/Textures	campaign_building
Prestige_capitol	RigidModels/CampaignBuildings/Textures	campaign_building
Prestige_dezwaan	RigidModels/CampaignBuildings/Textures	campaign_building
Prestige_granja	RigidModels/CampaignBuildings/Textures	campaign_building
Prestige_hofburg	RigidModels/CampaignBuildings/Textures	campaign_building
Prestige_kaerlskirche	RigidModels/CampaignBuildings/Textures	campaign_building
Prestige_konglig	RigidModels/CampaignBuildings/Textures	campaign_building
Prestige_kunstkamara	RigidModels/CampaignBuildings/Textures	campaign_building
Prestige_lazienki	RigidModels/CampaignBuildings/Textures	campaign_building
Prestige_ledreborg	RigidModels/CampaignBuildings/Textures	campaign_building
Prestige_osmaniye	RigidModels/CampaignBuildings/Textures	campaign_building
Prestige_palaciomadrid	RigidModels/CampaignBuildings/Textures	campaign_building
Prestige_polishakademia	RigidModels/CampaignBuildings/Textures	campaign_building
Prestige_somersethouse	RigidModels/CampaignBuildings/Textures	campaign_building
Prestige_swedishacademy	RigidModels/CampaignBuildings/Textures	campaign_building
Prestige_teylersmuseum	RigidModels/CampaignBuildings/Textures	campaign_building
Prestige_whitehouse	RigidModels/CampaignBuildings/Textures	campaign_building
Prestige_winterpalace	RigidModels/CampaignBuildings/Textures	campaign_building
Slot_resource_farm_corn	RigidModels/CampaignBuildings/Textures	campaign_building
Slot_resource_farm_wheat	RigidModels/CampaignBuildings/Textures	campaign_building
Slot_resource_plantation_caribbean	RigidModels/CampaignBuildings/Textures	campaign_building
Slot_resource_plantation_cuba	RigidModels/CampaignBuildings/Textures	campaign_building
Slot_resource_plantation_egypt	RigidModels/CampaignBuildings/Textures	campaign_building
Slot_resource_plantation_india_highlands	RigidModels/CampaignBuildings/Textures	campaign_building
Slot_resource_plantation_southern_usa	RigidModels/CampaignBuildings/Textures	campaign_building
Slot_resource_plantation_tropical_humid	RigidModels/CampaignBuildings/Textures	campaign_building
Wall_Asia_End_piece01_destruct01	RigidModels\BattleFieldProps\Textures	battle_misc
Wall_EU_East_End_piece01_destruct01	RigidModels\BattleFieldProps\Textures	battle_misc
Wall_EU_North_End_piece01_destruct01	RigidModels\BattleFieldProps\Textures	battle_misc
Wall_EU_South_End_piece01_destruct01	RigidModels\BattleFieldProps\Textures	battle_misc
Wall_EU_West_End_piece01_destruct01	RigidModels\BattleFieldProps\Textures	battle_misc
acropolis_angled_roof_piece01_destruct01	rigidmodels/buildings/textures	battle_building
acropolis_balastrade_piece01_destruct01	rigidmodels/buildings/textures	battle_building
acropolis_cylindrical_building_piece01_destruct01	rigidmodels/buildings/textures	battle_building
acropolis_foundations_piece01_destruct01	rigidmodels/buildings/textures	battle_building
acropolis_large_temple_piece01_destruct01	rigidmodels/buildings/textures	battle_building
acropolis_long_building_piece01_destruct01	rigidmodels/buildings/textures	battle_building
acropolis_piece01_destruct01	rigidmodels/buildings/textures	battle_building
acropolis_pillars_piece01_destruct01	rigidmodels/buildings/textures	battle_building
acropolis_small_long_piece01_destruct01	rigidmodels/buildings/textures	battle_building
acropolis_small_temple_piece01_destruct01	rigidmodels/buildings/textures	battle_building
acropolis_statue_piece01_destruct01	rigidmodels/buildings/textures	battle_building
acropolis_tiny_temple_piece01_destruct01	rigidmodels/buildings/textures	battle_building
agent_ID	RigidModels\Flags\Textures	campaign_template_extra
agora_base_block_piece01_destruct01	rigidmodels/buildings/textures	battle_building
agora_council_house_piece01_destruct01	rigidmodels/buildings/textures	battle_building
agora_long_building_piece01_destruct01	rigidmodels/buildings/textures	battle_building
agora_piece01_destruct01	rigidmodels/buildings/textures	battle_building
agora_porch_piece01_destruct01	rigidmodels/buildings/textures	battle_building
agora_small_courtyard_piece01_destruct01	rigidmodels/buildings/textures	battle_building
ambush_buildings_marker	RigidModels\WarscapeFrame\ai_hints\Textures	3Dindicators
ambush_forest_marker	RigidModels\WarscapeFrame\ai_hints\Textures	3Dindicators
ampetheatre_base_piece01_destruct01	rigidmodels/buildings/textures	battle_building
ampetheatre_piece01_destruct01	rigidmodels/buildings/textures	battle_building
ampetheatre_seats_piece01_destruct01	rigidmodels/buildings/textures	battle_building
ampetheatre_stage_piece01_destruct01	rigidmodels/buildings/textures	battle_building
army_banner_flag_general	UI/3DUI/textures/default/	incidental
army_banner_flag_heavy	UI/3DUI/textures/default/	incidental
army_banner_flag_light	UI/3DUI/textures/default/	incidental
army_banner_flag_medium	UI/3DUI/textures/default/	incidental
army_banner_flagpole	UI/3DUI/textures/default/	incidental
army_banner_flagpole_building	UI/3DUI/textures/default/	incidental
army_banner_flagpole_crossbar	UI/3DUI/textures/default/	incidental
army_banner_general_straps	UI/3DUI/textures/default/	incidental
army_banner_group_fill	UI/3DUI/textures/default/	incidental
army_banner_group_frame	UI/3DUI/textures/default/	incidental
army_banner_morale_fill	UI/3DUI/textures/default/	incidental
army_banner_morale_frame	UI/3DUI/textures/default/	incidental
army_banner_ping_marker	UI/3DUI/textures/default/	incidental
army_banner_ring	UI/3DUI/textures/default/	incidental
army_banner_ring_fill	UI/3DUI/textures/default/	incidental
army_banner_standard_top_general	UI/3DUI/textures/default/	incidental
army_banner_standard_top_generic	UI/3DUI/textures/default/	incidental
army_banner_star	UI/3DUI/textures/default/	incidental
army_banner_xp_fill	UI/3DUI/textures/default/	incidental
army_banner_xp_frame	UI/3DUI/textures/default/	incidental
arrow	RigidModels/Projectile/Textures	projectiles
artillery_proxy	RigidModels\UI\Textures	3Dindicators
bamboowall_piece01_destruct01_lod01	RigidModels/DeployableItems/Textures/BambooWall	battle_misc
barricade_a_straight_10m_piece01_destruct01	rigidmodels/buildings/textures	battle_building
basket_empty_a_large_piece01_destruct01	rigidmodels/buildings/textures	battle_building
basket_empty_a_large_piece01_destruct02	rigidmodels/buildings/textures	battle_building
basket_empty_a_piece01_destruct01	rigidmodels/buildings/textures	battle_building
basket_empty_a_piece01_destruct02	rigidmodels/buildings/textures	battle_building
basket_empty_b_large_piece01_destruct01	rigidmodels/buildings/textures	battle_building
basket_empty_b_large_piece01_destruct02	rigidmodels/buildings/textures	battle_building
basket_empty_b_piece01_destruct01	rigidmodels/buildings/textures	battle_building
basket_empty_b_piece01_destruct02	rigidmodels/buildings/textures	battle_building
basket_fish_a_large_piece01_destruct01	rigidmodels/buildings/textures	battle_building
basket_fish_a_large_piece01_destruct02	rigidmodels/buildings/textures	battle_building
basket_fish_a_piece01_destruct01	rigidmodels/buildings/textures	battle_building
basket_fish_a_piece01_destruct02	rigidmodels/buildings/textures	battle_building
basket_tea_large_piece01_destruct01	rigidmodels/buildings/textures	battle_building
basket_tea_large_piece01_destruct02	rigidmodels/buildings/textures	battle_building
basket_tea_piece01_destruct01	rigidmodels/buildings/textures	battle_building
basket_tea_piece01_destruct02	rigidmodels/buildings/textures	battle_building
battle_marker_rom_Barbarian	RigidModels\eventmarkers\textures	campaign_event_markers
battle_marker_rom_Eastern	RigidModels\eventmarkers\textures	campaign_event_markers
battle_marker_rom_Hellenistic	RigidModels\eventmarkers\textures	campaign_event_markers
battle_marker_rom_Roman	RigidModels\eventmarkers\textures	campaign_event_markers
battlefield_debris_07_piece07_destruct01	rigidmodels/buildings/textures	battle_building
boat_rack_piece01_destruct01	rigidmodels/buildings/textures	battle_building
boat_rack_piece01_destruct02	rigidmodels/buildings/textures	battle_building
boulder_a_piece01_destruct01	rigidmodels/buildings/textures	battle_building
boulder_small_c_piece01_destruct01	rigidmodels/buildings/textures	battle_building
boulder_small_d_piece01_destruct01	rigidmodels/buildings/textures	battle_building
box_flat_roof_piece01_destruct01	rigidmodels/buildings/textures	battle_building
breech_cannon_destroyed_anim	RigidModels/artillery/Textures	battle_misc
building_damage_castles_smoke	RigidModels/CampaignBuildings/Textures	campaign_building
camp_fire_large_piece01_destruct01	rigidmodels/buildings/textures	battle_building
campaign_building_blockade	RigidModels\CampaignBuildings\Textures	campaign_building
campaign_building_damage_smoke	RigidModels\CampaignBuildings\Textures	campaign_building
campaign_building_placeholder	RigidModels/CampaignBuildings/Textures	campaign_building
campaign_building_placeholder_particle	RigidModels/CampaignBuildings/Textures	campaign_building
campaign_castle_damage_smoke	RigidModels\CampaignBuildings\Textures	campaign_building
campaign_map_marker01	RigidModels\Flags\Textures	3Dindicators
campaign_map_marker02	RigidModels\Flags\textures	3Dindicators
campaign_settlement_building_smoke_lvl1	RigidModels\CampaignBuildings\Textures	campaign_building
campaign_settlement_building_smoke_lvl2	RigidModels\CampaignBuildings\Textures	campaign_building
campaign_settlement_building_smoke_lvl3	RigidModels\CampaignBuildings\Textures	campaign_building
campaign_settlement_building_smoke_lvl4	RigidModels\CampaignBuildings\Textures	campaign_building
campaign_settlement_building_smoke_lvl5	RigidModels\CampaignBuildings\Textures	campaign_building
campaign_ship_projectile	RigidModels\CampaignProps\Textures	campaign_building
campaign_ship_projectile_01	RigidModels\CampaignProps\Textures	campaign_building
campaign_ship_projectile_02	RigidModels\CampaignProps\Textures	campaign_building
campaign_ship_projectile_03	RigidModels\CampaignProps\Textures	campaign_building
campaign_ship_projectile_04	RigidModels\CampaignProps\Textures	campaign_building
campaign_sho_archery_1_archery_dojo	RigidModels\CampaignBuildings\Textures	campaign_building
campaign_sho_archery_2_foot_archery	RigidModels\CampaignBuildings\Textures	campaign_building
campaign_sho_archery_3_bow_master_dojo	RigidModels\CampaignBuildings\Textures	campaign_building
campaign_sho_archery_4_legendary_dojo	RigidModels\CampaignBuildings\Textures	campaign_building
campaign_sho_bridge_lvl1	RigidModels/CampaignBuildings/Textures	campaign_building
campaign_sho_bridge_lvl2	RigidModels/CampaignBuildings/Textures	campaign_building
campaign_sho_bridge_lvl3	RigidModels/CampaignBuildings/Textures	campaign_building
campaign_sho_buddhist_1_temple	RigidModels\CampaignBuildings\Textures	campaign_building
campaign_sho_buddhist_2_monastery	RigidModels\CampaignBuildings\Textures	campaign_building
campaign_sho_buddhist_3_temple_complex	RigidModels\CampaignBuildings\Textures	campaign_building
campaign_sho_buddhist_4_legendary_temple	RigidModels\CampaignBuildings\Textures	campaign_building
campaign_sho_buff_1_encampment	RigidModels\CampaignBuildings\Textures	campaign_building
campaign_sho_buff_2_armoury	RigidModels\CampaignBuildings\Textures	campaign_building
campaign_sho_buff_2_barracks	RigidModels\CampaignBuildings\Textures	campaign_building
campaign_sho_buff_2_hunting_lodge	RigidModels\CampaignBuildings\Textures	campaign_building
campaign_sho_buff_2_jiujutsu_dojo	RigidModels\CampaignBuildings\Textures	campaign_building
campaign_sho_buff_2_proving_grounds	RigidModels\CampaignBuildings\Textures	campaign_building
campaign_sho_castle_1_fort	RigidModels/CampaignBuildings/Textures	campaign_building
campaign_sho_castle_2_stronghold	RigidModels/CampaignBuildings/Textures	campaign_building
campaign_sho_castle_2_stronghold:sho_custom_kyoto	RigidModels/CampaignBuildings/Textures	campaign_building
campaign_sho_castle_3_fortress	RigidModels/CampaignBuildings/Textures	campaign_building
campaign_sho_castle_3_fortress:sho_custom_kyoto	RigidModels/CampaignBuildings/Textures	campaign_building
campaign_sho_castle_4_castle	RigidModels/CampaignBuildings/Textures	campaign_building
campaign_sho_castle_4_castle:sho_custom_kyoto	RigidModels/CampaignBuildings/Textures	campaign_building
campaign_sho_castle_5_citadel	RigidModels/CampaignBuildings/Textures	campaign_building
campaign_sho_castle_5_citadel:sho_custom_kyoto	RigidModels/CampaignBuildings/Textures	campaign_building
campaign_sho_cavalry_1_stables	RigidModels\CampaignBuildings\Textures	campaign_building
campaign_sho_cavalry_2_warhorse_stables	RigidModels\CampaignBuildings\Textures	campaign_building
campaign_sho_cavalry_3_bajutsu_master	RigidModels\CampaignBuildings\Textures	campaign_building
campaign_sho_cavalry_4_legendary_bajutsu_dojo	RigidModels\CampaignBuildings\Textures	campaign_building
campaign_sho_christian_1_chapel	RigidModels\CampaignBuildings\Textures	campaign_building
campaign_sho_christian_2_mission	RigidModels\CampaignBuildings\Textures	campaign_building
campaign_sho_christian_3_church	RigidModels\CampaignBuildings\Textures	campaign_building
campaign_sho_christian_4_cathedral	RigidModels\CampaignBuildings\Textures	campaign_building
campaign_sho_city_castle_construction_lvl1	RigidModels\CampaignBuildings\building_construction\Textures	campaign_building
campaign_sho_city_castle_construction_lvl2	RigidModels\CampaignBuildings\building_construction\Textures	campaign_building
campaign_sho_city_castle_construction_lvl2:sho_custom_kyoto	RigidModels\CampaignBuildings\building_construction\Textures	campaign_building
campaign_sho_city_castle_construction_lvl3	RigidModels\CampaignBuildings\building_construction\Textures	campaign_building
campaign_sho_city_castle_construction_lvl3:sho_custom_kyoto	RigidModels\CampaignBuildings\building_construction\Textures	campaign_building
campaign_sho_city_castle_construction_lvl4	RigidModels\CampaignBuildings\building_construction\Textures	campaign_building
campaign_sho_city_castle_construction_lvl4:sho_custom_kyoto	RigidModels\CampaignBuildings\building_construction\Textures	campaign_building
campaign_sho_city_castle_construction_lvl5	RigidModels\CampaignBuildings\building_construction\Textures	campaign_building
campaign_sho_city_castle_construction_lvl5:sho_custom_kyoto	RigidModels\CampaignBuildings\building_construction\Textures	campaign_building
campaign_sho_city_settlement_construction_lvl1	RigidModels\CampaignBuildings\building_construction\Textures	campaign_building
campaign_sho_city_settlement_construction_lvl2	RigidModels\CampaignBuildings\building_construction\Textures	campaign_building
campaign_sho_city_settlement_construction_lvl3	RigidModels\CampaignBuildings\building_construction\Textures	campaign_building
campaign_sho_city_settlement_construction_lvl4	RigidModels\CampaignBuildings\building_construction\Textures	campaign_building
campaign_sho_city_settlement_construction_lvl5	RigidModels\CampaignBuildings\building_construction\Textures	campaign_building
campaign_sho_crafts_1_market	RigidModels\CampaignBuildings\Textures	campaign_building
campaign_sho_crafts_2_rice_exchange	RigidModels\CampaignBuildings\Textures	campaign_building
campaign_sho_crafts_3_merchant_guild	RigidModels\CampaignBuildings\Textures	campaign_building
campaign_sho_crafts_4_kanabukama	RigidModels\CampaignBuildings\Textures	campaign_building
campaign_sho_farming_1_rice_paddies	RigidModels/CampaignBuildings/Textures	campaign_building
campaign_sho_farming_2_irrigation	RigidModels/CampaignBuildings/Textures	campaign_building
campaign_sho_farming_3_terraces	RigidModels/CampaignBuildings/Textures	campaign_building
campaign_sho_farming_4_consolidation	RigidModels/CampaignBuildings/Textures	campaign_building
campaign_sho_infrastructure_0_trails	RigidModels\CampaignBuildings\Textures	campaign_building
campaign_sho_infrastructure_1_roads	RigidModels\CampaignBuildings\Textures	campaign_building
campaign_sho_infrastructure_2_post_stations	RigidModels\CampaignBuildings\Textures	campaign_building
campaign_sho_infrastructure_3_imperial_roads	RigidModels\CampaignBuildings\Textures	campaign_building
campaign_sho_kyoto_2_stronghold	RigidModels/CampaignBuildings/Textures	campaign_building
campaign_sho_kyoto_3_fortress	RigidModels/CampaignBuildings/Textures	campaign_building
campaign_sho_kyoto_4_castle	RigidModels/CampaignBuildings/Textures	campaign_building
campaign_sho_kyoto_5_citadel	RigidModels/CampaignBuildings/Textures	campaign_building
campaign_sho_port_0_coastal_village	RigidModels/CampaignBuildings/Textures	campaign_building
campaign_sho_port_1_harbour	RigidModels/CampaignBuildings/Textures	campaign_building
campaign_sho_port_2_trading_port	RigidModels/CampaignBuildings/Textures	campaign_building
campaign_sho_port_3_military_port	RigidModels/CampaignBuildings/Textures	campaign_building
campaign_sho_port_3_nanban_trade_port	RigidModels/CampaignBuildings/Textures	campaign_building
campaign_sho_port_4_drydock	RigidModels/CampaignBuildings/Textures	campaign_building
campaign_sho_port_4_nanban_quarter	RigidModels/CampaignBuildings/Textures	campaign_building
campaign_sho_port_large_construction	RigidModels\CampaignBuildings\building_construction\Textures	campaign_building
campaign_sho_port_small_construction	RigidModels\CampaignBuildings\building_construction\Textures	campaign_building
campaign_sho_region_large_construction	RigidModels\CampaignBuildings\building_construction\Textures	campaign_building
campaign_sho_region_medium_construction	RigidModels\CampaignBuildings\building_construction\Textures	campaign_building
campaign_sho_region_small_construction	RigidModels\CampaignBuildings\building_construction\Textures	campaign_building
campaign_sho_region_specialty_craftwork_1_artisans	RigidModels/CampaignBuildings/Textures	campaign_building
campaign_sho_region_specialty_craftwork_2_fletchers	RigidModels/CampaignBuildings/Textures	campaign_building
campaign_sho_region_specialty_craftwork_2_paper_mills	RigidModels/CampaignBuildings/Textures	campaign_building
campaign_sho_region_specialty_craftwork_3_laquerware	RigidModels/CampaignBuildings/Textures	campaign_building
campaign_sho_region_specialty_craftwork_3_master_bowmaker	RigidModels/CampaignBuildings/Textures	campaign_building
campaign_sho_region_specialty_gold_mining_1_surface_mining	RigidModels/CampaignBuildings/Textures	campaign_building
campaign_sho_region_specialty_gold_mining_2_open_pit	RigidModels/CampaignBuildings/Textures	campaign_building
campaign_sho_region_specialty_holy_site_1_holy_site	RigidModels/CampaignBuildings/Textures	campaign_building
campaign_sho_region_specialty_holy_site_2_mountain_hermitag	RigidModels/CampaignBuildings/Textures	campaign_building
campaign_sho_region_specialty_holy_site_2_pilgrim_hostel	RigidModels/CampaignBuildings/Textures	campaign_building
campaign_sho_region_specialty_holy_site_3_fortified_monaste	RigidModels/CampaignBuildings/Textures	campaign_building
campaign_sho_region_specialty_holy_site_3_great_soja_shrine	RigidModels/CampaignBuildings/Textures	campaign_building
campaign_sho_region_specialty_intellectual_centre_1_school	RigidModels/CampaignBuildings/Textures	campaign_building
campaign_sho_region_specialty_intellectual_centre_2_library	RigidModels/CampaignBuildings/Textures	campaign_building
campaign_sho_region_specialty_intellectual_centre_2_magistr	RigidModels/CampaignBuildings/Textures	campaign_building
campaign_sho_region_specialty_intellectual_centre_3_academy	RigidModels/CampaignBuildings/Textures	campaign_building
campaign_sho_region_specialty_intellectual_centre_3_law_cou	RigidModels/CampaignBuildings/Textures	campaign_building
campaign_sho_region_specialty_iron_mining_1_iron_mine	RigidModels/CampaignBuildings/Textures	campaign_building
campaign_sho_region_specialty_iron_mining_2_deep_mine	RigidModels/CampaignBuildings/Textures	campaign_building
campaign_sho_region_specialty_naval_1_fishing_port	RigidModels/CampaignBuildings/Textures	campaign_building
campaign_sho_region_specialty_naval_2_pirate_cove	RigidModels/CampaignBuildings/Textures	campaign_building
campaign_sho_region_specialty_naval_2_whaling_port	RigidModels/CampaignBuildings/Textures	campaign_building
campaign_sho_region_specialty_naval_3_pirate_fortress	RigidModels/CampaignBuildings/Textures	campaign_building
campaign_sho_region_specialty_naval_3_red_seal_port	RigidModels/CampaignBuildings/Textures	campaign_building
campaign_sho_region_specialty_ninja_1_hideout	RigidModels/CampaignBuildings/Textures	campaign_building
campaign_sho_region_specialty_ninja_2_burakumin	RigidModels/CampaignBuildings/Textures	campaign_building
campaign_sho_region_specialty_ninja_2_ninjutsu_school	RigidModels/CampaignBuildings/Textures	campaign_building
campaign_sho_region_specialty_ninja_3_clan_fortress	RigidModels/CampaignBuildings/Textures	campaign_building
campaign_sho_region_specialty_ninja_3_smuggling_network	RigidModels/CampaignBuildings/Textures	campaign_building
campaign_sho_region_specialty_smithing_1_blacksmith	RigidModels/CampaignBuildings/Textures	campaign_building
campaign_sho_region_specialty_smithing_2_armourer	RigidModels/CampaignBuildings/Textures	campaign_building
campaign_sho_region_specialty_smithing_2_weaponsmith	RigidModels/CampaignBuildings/Textures	campaign_building
campaign_sho_region_specialty_smithing_3_master_armourer	RigidModels/CampaignBuildings/Textures	campaign_building
campaign_sho_region_specialty_smithing_3_master_weaponsmith	RigidModels/CampaignBuildings/Textures	campaign_building
campaign_sho_region_specialty_timber_1_lumbercamp	RigidModels/CampaignBuildings/Textures	campaign_building
campaign_sho_region_specialty_timber_2_lumberyards	RigidModels/CampaignBuildings/Textures	campaign_building
campaign_sho_region_specialty_timber_3_sawmills	RigidModels/CampaignBuildings/Textures	campaign_building
campaign_sho_siege_1_workshop	RigidModels\CampaignBuildings\Textures	campaign_building
campaign_sho_siege_2_powder_maker	RigidModels\CampaignBuildings\Textures	campaign_building
campaign_sho_siege_3_gunsmith	RigidModels\CampaignBuildings\Textures	campaign_building
campaign_sho_siege_4_arsenal	RigidModels\CampaignBuildings\Textures	campaign_building
campaign_sho_stealth_1_sake_den	RigidModels\CampaignBuildings\Textures	campaign_building
campaign_sho_stealth_2_gambling_hall	RigidModels\CampaignBuildings\Textures	campaign_building
campaign_sho_stealth_3_criminal_syndicate	RigidModels\CampaignBuildings\Textures	campaign_building
campaign_sho_stealth_4_mizu_shobai	RigidModels\CampaignBuildings\Textures	campaign_building
campaign_sho_sword_1_sword_school	RigidModels\CampaignBuildings\Textures	campaign_building
campaign_sho_sword_2_nodachi	RigidModels\CampaignBuildings\Textures	campaign_building
campaign_sho_sword_3_master_dojo	RigidModels\CampaignBuildings\Textures	campaign_building
campaign_sho_sword_4_legendary_dojo	RigidModels\CampaignBuildings\Textures	campaign_building
campaign_sho_yari_1_drill_yard	RigidModels\CampaignBuildings\Textures	campaign_building
campaign_sho_yari_2_naginata_dojo	RigidModels\CampaignBuildings\Textures	campaign_building
campaign_sho_yari_3_master_dojo	RigidModels\CampaignBuildings\Textures	campaign_building
campaign_sho_yari_4_legendary_school	RigidModels\CampaignBuildings\Textures	campaign_building
capture_point_icon	UI/3DUI/textures/default/	incidental
carthage_blockout_v5_piece01_destruct01	rigidmodels/buildings/textures	battle_building
carthage_blockout_v5a_piece01_destruct01	rigidmodels/buildings/textures	battle_building
carthage_blockout_v5b_piece01_destruct01	rigidmodels/buildings/textures	battle_building
carthage_blockout_v5c_piece01_destruct01	rigidmodels/buildings/textures	battle_building
carthage_blockout_v5d_piece01_destruct01	rigidmodels/buildings/textures	battle_building
carthage_blockout_v5e_piece01_destruct01	rigidmodels/buildings/textures	battle_building
carthage_blockout_v5f_piece01_destruct01	rigidmodels/buildings/textures	battle_building
carthage_blockout_v5g_piece01_destruct01	rigidmodels/buildings/textures	battle_building
carthage_blockout_v5h_piece01_destruct01	rigidmodels/buildings/textures	battle_building
carthage_blockout_v5i_piece01_destruct01	rigidmodels/buildings/textures	battle_building
carthage_blockout_v5j_piece01_destruct01	rigidmodels/buildings/textures	battle_building
carthage_blockout_v5k_piece01_destruct01	rigidmodels/buildings/textures	battle_building
carthage_build_diag02_piece14_destruct01	rigidmodels/buildings/textures	battle_building
carthage_build_house01_piece04_destruct01	rigidmodels/buildings/textures	battle_building
carthage_build_house02_piece05_destruct01	rigidmodels/buildings/textures	battle_building
carthage_build_house03_piece06_destruct01	rigidmodels/buildings/textures	battle_building
carthage_build_house04_piece07_destruct01	rigidmodels/buildings/textures	battle_building
carthage_build_house05_piece08_destruct01	rigidmodels/buildings/textures	battle_building
carthage_build_house06_piece09_destruct01	rigidmodels/buildings/textures	battle_building
carthage_build_house07_piece10_destruct01	rigidmodels/buildings/textures	battle_building
carthage_build_house08_piece11_destruct01	rigidmodels/buildings/textures	battle_building
carthage_build_house09_piece12_destruct01	rigidmodels/buildings/textures	battle_building
carthage_build_house10_piece13_destruct01	rigidmodels/buildings/textures	battle_building
carthage_build_square01_piece02_destruct01	rigidmodels/buildings/textures	battle_building
carthage_build_square02_piece03_destruct01	rigidmodels/buildings/textures	battle_building
carthage_build_square03_piece23_destruct01	rigidmodels/buildings/textures	battle_building
carthage_build_square04_piece17_destruct01	rigidmodels/buildings/textures	battle_building
carthage_build_square_large01_piece16_destruct01	rigidmodels/buildings/textures	battle_building
carthage_build_square_large02_piece15_destruct01	rigidmodels/buildings/textures	battle_building
carthage_citadel_large_piece19_destruct01	rigidmodels/buildings/textures	battle_building
carthage_citadel_medium_piece24_destruct01	rigidmodels/buildings/textures	battle_building
carthage_citadel_small_piece25_destruct01	rigidmodels/buildings/textures	battle_building
carthage_cothon_large_piece20_destruct01	rigidmodels/buildings/textures	battle_building
carthage_cothon_medium_piece22_destruct01	rigidmodels/buildings/textures	battle_building
carthage_cothon_ring_v6_piece01_destruct01	rigidmodels/buildings/textures/monument	battle_building
carthage_cothon_small_piece21_destruct01	rigidmodels/buildings/textures	battle_building
carthage_lighthouse_piece01_destruct01	rigidmodels/buildings/textures	battle_building
carthage_steps10m_piece30_destruct01	rigidmodels/buildings/textures	battle_building
carthage_steps6m_piece28_destruct01	rigidmodels/buildings/textures	battle_building
carthage_steps8m_piece29_destruct01	rigidmodels/buildings/textures	battle_building
carthage_street_plan_v4_piece01_destruct01	rigidmodels/buildings/textures	battle_building
carthage_stronghold_piece31_destruct01	rigidmodels/buildings/textures	battle_building
carthage_trireme_bow_01_dm1	RigidModels/Naval/Textures	campaign_building
carthage_trireme_bow_02_dm1	RigidModels/Naval/Textures	campaign_building
carthage_trireme_bow_03_dm1	RigidModels/Naval/Textures	campaign_building
carthage_trireme_mast_02_dm1	RigidModels/Naval/Textures	campaign_building
carthage_trireme_misc_01_dm1	RigidModels/Naval/Textures	campaign_building
carthage_trireme_port_01_dm1	RigidModels/Naval/Textures	campaign_building
carthage_trireme_port_02_dm1	RigidModels/Naval/Textures	campaign_building
carthage_trireme_port_03_dm1	RigidModels/Naval/Textures	campaign_building
carthage_trireme_port_04_dm1	RigidModels/Naval/Textures	campaign_building
carthage_trireme_port_05_dm1	RigidModels/Naval/Textures	campaign_building
carthage_trireme_starb_01_dm1	RigidModels/Naval/Textures	campaign_building
carthage_trireme_starb_02_dm1	RigidModels/Naval/Textures	campaign_building
carthage_trireme_starb_03_dm1	RigidModels/Naval/Textures	campaign_building
carthage_trireme_starb_04_dm1	RigidModels/Naval/Textures	campaign_building
carthage_trireme_starb_05_dm1	RigidModels/Naval/Textures	campaign_building
carthage_trireme_stern_01_dm1	RigidModels/Naval/Textures	campaign_building
carthage_trireme_stern_02_dm1	RigidModels/Naval/Textures	campaign_building
carthage_v4_capture_area_piece01_destruct01	rigidmodels/buildings/textures	battle_building
carthage_v4_cothon_piece01_destruct01	rigidmodels/buildings/textures	battle_building
carthage_v4_walls_piece01_destruct01	rigidmodels/buildings/textures	battle_building
carthage_warehouse_large_piece27_destruct01	rigidmodels/buildings/textures	battle_building
carthage_warehouse_medium_piece18_destruct01	rigidmodels/buildings/textures	battle_building
carthage_warehouse_small_piece26_destruct01	rigidmodels/buildings/textures	battle_building
carthage_wharf20m_piece32_destruct01	rigidmodels/buildings/textures	battle_building
carthage_wharf40m_piece33_destruct01	rigidmodels/buildings/textures	battle_building
cavalry_proxy	RigidModels\UI\Textures	3Dindicators
chariot_celtic_destroyed	rigidmodels/buildings/textures	battle_building
chariot_egyptian_destroyed	rigidmodels/buildings/textures	battle_building
chariot_generic_destroyed	rigidmodels/buildings/textures	battle_building
chariot_roman_destroyed	rigidmodels/buildings/textures	battle_building
choke_point_marker	RigidModels\WarscapeFrame\ai_hints\Textures	3Dindicators
cinematics_camp_fire_piece01_destruct01	rigidmodels/buildings/textures	battle_building
city_east_building_01	RigidModels\city_buildings\east\textures	battle_building
city_east_building_02	RigidModels\city_buildings\east\textures	battle_building
city_east_building_03	RigidModels\city_buildings\east\textures	battle_building
city_east_building_04	RigidModels\city_buildings\east\textures	battle_building
city_east_building_05	RigidModels\city_buildings\east\textures	battle_building
city_east_building_06	RigidModels\city_buildings\east\textures	battle_building
city_east_building_07	RigidModels\city_buildings\east\textures	battle_building
city_east_church	RigidModels\city_buildings\east\textures	battle_building
city_east_townhall	RigidModels\city_buildings\east\textures	battle_building
city_euro_building_01	RigidModels\city_buildings\euro\textures	battle_building
city_euro_building_02	RigidModels\city_buildings\euro\textures	battle_building
city_euro_building_03	RigidModels\city_buildings\euro\textures	battle_building
city_euro_building_04	RigidModels\city_buildings\euro\textures	battle_building
city_euro_building_05	RigidModels\city_buildings\euro\textures	battle_building
city_euro_building_06	RigidModels\city_buildings\euro\textures	battle_building
city_euro_building_07	RigidModels\city_buildings\euro\textures	battle_building
city_euro_church	RigidModels\city_buildings\euro\textures	battle_building
city_euro_townhall	RigidModels\city_buildings\euro\textures	battle_building
city_native_building_01	RigidModels\city_buildings\native\textures	battle_building
city_native_building_03	RigidModels\city_buildings\native\textures	battle_building
city_native_church	RigidModels\city_buildings\native\textures	battle_building
city_native_townhall	RigidModels\city_buildings\native\textures	battle_building
city_us_building_01	RigidModels\city_buildings\us\textures	battle_building
city_us_building_02	RigidModels\city_buildings\us\textures	battle_building
city_us_building_03	RigidModels\city_buildings\us\textures	battle_building
city_us_building_04	RigidModels\city_buildings\us\textures	battle_building
city_us_building_05	RigidModels\city_buildings\us\textures	battle_building
city_us_building_06	RigidModels\city_buildings\us\textures	battle_building
city_us_building_07	RigidModels\city_buildings\us\textures	battle_building
city_us_church	RigidModels\city_buildings\us\textures	battle_building
city_us_townhall	RigidModels\city_buildings\us\textures	battle_building
coast_sound_emitter_marker	RigidModels\WarscapeFrame\sound_emitters\textures	3Dindicators
combat_ratio	RigidModels/Flags/Textures/	incidental
cover_marker	RigidModels\WarscapeFrame\ai_hints\Textures	3Dindicators
crane_cinematics_piece01_destruct01	rigidmodels/buildings/textures	battle_building
crane_piece01_destruct01	rigidmodels/buildings/textures	battle_building
cylindrical_building01_piece01_destruct01	rigidmodels/buildings/textures	battle_building
dead_ground_marker	RigidModels\WarscapeFrame\ai_hints\Textures	3Dindicators
defensive_line_marker	RigidModels\WarscapeFrame\ai_hints\Textures	3Dindicators
deployable_item_fougasse	RigidModels/DeployableItems/fougasse/Textures	battle_misc
dock_amphoras_piece01_destruct01	rigidmodels/buildings/textures	battle_building
dock_barrels_piece01_destruct01	rigidmodels/buildings/textures	battle_building
dock_cargo_1_piece01_destruct01	rigidmodels/buildings/textures	battle_building
dock_cargo_2_piece01_destruct01	rigidmodels/buildings/textures	battle_building
dock_cargo_3_piece01_destruct01	rigidmodels/buildings/textures	battle_building
dock_corner_concav_1_piece01_destruct01	rigidmodels/buildings/textures	battle_building
dock_corner_convex_1_piece01_destruct01	rigidmodels/buildings/textures	battle_building
dock_end_left_piece01_destruct01	rigidmodels/buildings/textures	battle_building
dock_end_right_piece01_destruct01	rigidmodels/buildings/textures	battle_building
dock_fishing_shed_1_piece01_destruct01	rigidmodels/buildings/textures	battle_building
dock_fishing_shed_2_piece01_destruct01	rigidmodels/buildings/textures	battle_building
dock_fishing_shed_3_piece01_destruct01	rigidmodels/buildings/textures	battle_building
dock_fishing_shed_platform_1_piece01_destruct01	rigidmodels/buildings/textures	battle_building
dock_fishing_shed_platform_2_piece01_destruct01	rigidmodels/buildings/textures	battle_building
dock_offset_left_1_piece01_destruct01	rigidmodels/buildings/textures	battle_building
dock_offset_left_2_piece01_destruct01	rigidmodels/buildings/textures	battle_building
dock_offset_right_1_piece01_destruct01	rigidmodels/buildings/textures	battle_building
dock_offset_right_2_piece01_destruct01	rigidmodels/buildings/textures	battle_building
dock_ship_shed_large_piece01_destruct01	rigidmodels/buildings/textures	battle_building
dock_ship_shed_small_piece01_destruct01	rigidmodels/buildings/textures	battle_building
dock_straight_1_piece01_destruct01	rigidmodels/buildings/textures	battle_building
dock_straight_2_piece01_destruct01	rigidmodels/buildings/textures	battle_building
dock_straight_3_piece01_destruct01	rigidmodels/buildings/textures	battle_building
dock_straight_4_piece01_destruct01	rigidmodels/buildings/textures	battle_building
dock_straight_5_piece01_destruct01	rigidmodels/buildings/textures	battle_building
dock_warehouse_1_piece01_destruct01	rigidmodels/buildings/textures	battle_building
dock_warehouse_2_piece01_destruct01	rigidmodels/buildings/textures	battle_building
dock_wood_1_piece01_destruct01	rigidmodels/buildings/textures	battle_building
dock_wood_2_piece01_destruct01	rigidmodels/buildings/textures	battle_building
dock_wood_3_piece01_destruct01	rigidmodels/buildings/textures	battle_building
double_block_houses_piece01_destruct01	rigidmodels/buildings/textures	battle_building
facing_arrow_proxy	RigidModels\UI\Textures	3Dindicators
famous_battle_event_marker_default	RigidModels/EventMarkers/Textures	campaign_event_markers
flag_capturepoint_cloth_crossbar	UI\3DUI\textures\default	battle_misc
flag_capturepoint_cloth_flag	UI\3DUI\textures\default	battle_misc
flag_capturepoint_cloth_pole	UI\3DUI\textures\default	battle_misc
flag_capturepoint_piece01_destruct01	rigidmodels/buildings/textures	battle_building
flat_roof_corner_house_piece01_destruct01	rigidmodels/buildings/textures	battle_building
flat_roof_double_block_piece01_destruct01	rigidmodels/buildings/textures	battle_building
flat_roof_long_block_piece01_destruct01	rigidmodels/buildings/textures	battle_building
flat_roof_steps_piece01_destruct01	rigidmodels/buildings/textures	battle_building
flat_roofed_houses02_piece01_destruct01	rigidmodels/buildings/textures	battle_building
flat_roofed_houses_piece01_destruct01	rigidmodels/buildings/textures	battle_building
fmv_cross1_piece01_destruct01	RigidModels\Buildings\AAA_TEXTURES	battle_building
fort_carthage_stockade_10_piece01_destruct01	rigidmodels/buildings/textures	battle_building
fort_rome_testv1_10_01_piece04_destruct01	rigidmodels/buildings/textures	battle_building
fort_rome_testv1_10_tower_piece06_destruct01	rigidmodels/buildings/textures	battle_building
fort_rome_testv1_20_01_piece07_destruct01	rigidmodels/buildings/textures	battle_building
fort_rome_testv1_20_01_piece07_destruct02	rigidmodels/buildings/textures	battle_building
fort_rome_testv1_40_01_piece01_destruct01	rigidmodels/buildings/textures	battle_building
fort_rome_testv1_40_01_piece01_destruct02	rigidmodels/buildings/textures	battle_building
fort_rome_testv1_80_01_piece08_destruct01	rigidmodels/buildings/textures	battle_building
fort_rome_testv1_80_01_piece08_destruct02	rigidmodels/buildings/textures	battle_building
fort_rome_testv1_corner90_piece02_destruct01	rigidmodels/buildings/textures	battle_building
fort_rome_testv1_gate01_piece03_destruct01	rigidmodels/buildings/textures	battle_building
fort_rome_testv1_gate01_piece09_destruct01_gate_closed	rigidmodels/buildings/textures	battle_building
fort_rome_testv1_gate01_piece09_destruct01_gate_open	rigidmodels/buildings/textures	battle_building
fort_rome_testv1_gate01_piece09_destruct02_gate_closed	rigidmodels/buildings/textures	battle_building
fort_rome_testv1_gate01_piece09_destruct02_gate_open	rigidmodels/buildings/textures	battle_building
fort_rome_testv1_gate02_piece05_destruct01	rigidmodels/buildings/textures	battle_building
fort_rome_testv1_gate02_piece10_destruct01_gate_closed	rigidmodels/buildings/textures	battle_building
fort_rome_testv1_gate02_piece10_destruct01_gate_open	rigidmodels/buildings/textures	battle_building
fort_rome_testv1_gate02_piece10_destruct02_gate_closed	rigidmodels/buildings/textures	battle_building
fort_rome_testv1_gate02_piece10_destruct02_gate_open	rigidmodels/buildings/textures	battle_building
fort_rome_testv1_gate02_piece11_destruct01_gate_closed	rigidmodels/buildings/textures	battle_building
fort_rome_testv1_gate02_piece11_destruct01_gate_open	rigidmodels/buildings/textures	battle_building
fort_rome_testv1_gate02_piece11_destruct02_gate_closed	rigidmodels/buildings/textures	battle_building
fort_rome_testv1_gate02_piece11_destruct02_gate_open	rigidmodels/buildings/textures	battle_building
fort_rome_testv2_10_01_piece04_destruct01	rigidmodels/buildings/textures	battle_building
fort_rome_testv2_40_01_piece01_destruct01	rigidmodels/buildings/textures	battle_building
fort_rome_testv2_barracks_piece07_destruct01	rigidmodels/buildings/textures	battle_building
fort_rome_testv2_corner90_piece02_destruct01	rigidmodels/buildings/textures	battle_building
fort_rome_testv2_gate01_piece03_destruct01	rigidmodels/buildings/textures	battle_building
fort_rome_testv2_gate01_piece09_destruct01_gate_closed	rigidmodels/buildings/textures	battle_building
fort_rome_testv2_gate01_piece09_destruct01_gate_open	rigidmodels/buildings/textures	battle_building
fort_rome_testv2_gate01_piece09_destruct02_gate_closed	rigidmodels/buildings/textures	battle_building
fort_rome_testv2_gate01_piece09_destruct02_gate_open	rigidmodels/buildings/textures	battle_building
fort_rome_testv2_house_piece08_destruct01	rigidmodels/buildings/textures	battle_building
fort_rome_testv2_principia_piece09_destruct01	rigidmodels/buildings/textures	battle_building
fountain_seats_piece01_destruct01	rigidmodels/buildings/textures	battle_building
garden_buildings_piece01_destruct01	rigidmodels/buildings/textures	battle_building
generic_circle	RigidModels/Flags/Textures/	incidental
good_cavalry_ground_marker	RigidModels\WarscapeFrame\ai_hints\Textures	3Dindicators
grapple	RigidModels/Projectile/empire_projectile_tex	projectiles
greek_agora_2storey_building01_piece01_destruct01	rigidmodels/buildings/textures	battle_building
greek_agora_2storey_building01_piece01_destruct02	rigidmodels/buildings/textures	battle_building
greek_agora_2storey_building01_piece01_destruct03	rigidmodels/buildings/textures	battle_building
greek_agora_2storey_building02_piece01_destruct01	rigidmodels/buildings/textures	battle_building
greek_agora_main_hall_big_piece01_destruct01	rigidmodels/buildings/textures	battle_building
greek_agora_main_hall_piece01_destruct01	rigidmodels/buildings/textures	battle_building
greek_agora_small_building01_piece01_destruct01	rigidmodels/buildings/textures	battle_building
greek_apartment_balcony01_piece01_destruct01	rigidmodels/buildings/textures	battle_building
greek_apartment_balcony02a_piece01_destruct01	rigidmodels/buildings/textures	battle_building
greek_apartment_balcony02b_piece01_destruct01	rigidmodels/buildings/textures	battle_building
greek_apartment_balcony02c_piece01_destruct01	rigidmodels/buildings/textures	battle_building
greek_apartment_balcony03_piece01_destruct01	rigidmodels/buildings/textures	battle_building
greek_apartment_build_over01_piece01_destruct01	rigidmodels/buildings/textures	battle_building
greek_apartment_building01_piece01_destruct01	rigidmodels/buildings/textures	battle_building
greek_apartment_building01b_piece01_destruct01	rigidmodels/buildings/textures	battle_building
greek_apartment_building02-2_piece01_destruct01	rigidmodels/buildings/textures	battle_building
greek_apartment_building02_piece01_destruct01	rigidmodels/buildings/textures	battle_building
greek_apartment_building03_piece01_destruct01	rigidmodels/buildings/textures	battle_building
greek_civic_wall_4m_piece01_destruct01	rigidmodels/buildings/textures	battle_building
greek_civic_wall_8m_piece01_destruct01	rigidmodels/buildings/textures	battle_building
greek_civic_wall_arched_door_piece01_destruct01	rigidmodels/buildings/textures	battle_building
greek_civic_wall_corner_piece01_destruct01	rigidmodels/buildings/textures	battle_building
greek_civic_wall_end_piece01_destruct01	rigidmodels/buildings/textures	battle_building
greek_domestic_occupiable_10fps_piece01_destruct01	rigidmodels/buildings/textures	battle_building
greek_domestic_occupiable_10fps_piece01_destruct02	rigidmodels/buildings/textures	battle_building
greek_domestic_occupiable_1_piece01_destruct01	rigidmodels/buildings/textures	battle_building
greek_domestic_occupiable_1_piece01_destruct02	rigidmodels/buildings/textures	battle_building
greek_extras_porch01_piece01_destruct01	rigidmodels/buildings/textures	battle_building
greek_extras_tower01_piece01_destruct01	rigidmodels/buildings/textures	battle_building
greek_extras_tower02_piece01_destruct01	rigidmodels/buildings/textures	battle_building
greek_extras_tower03_piece01_destruct01	rigidmodels/buildings/textures	battle_building
greek_extras_towertop_piece01_destruct01	rigidmodels/buildings/textures	battle_building
greek_flat_roof_1_storey_a_piece01_destruct01	rigidmodels/buildings/textures	battle_building
greek_flat_roof_1_storey_b_piece01_destruct01	rigidmodels/buildings/textures	battle_building
greek_flat_roof_2_storey_a_piece01_destruct01	rigidmodels/buildings/textures	battle_building
greek_flat_roof_3_storey_piece01_destruct01	rigidmodels/buildings/textures	battle_building
greek_fort_external_corner_piece01_destruct01	rigidmodels/buildings/textures	battle_building
greek_fort_external_grid_to_angled_joiner_piece01_destruct01	rigidmodels/buildings/textures	battle_building
greek_fort_gateway_e_piece01_destruct01	rigidmodels/buildings/textures	battle_building
greek_fort_gateway_e_piece01_destruct02	rigidmodels/buildings/textures	battle_building
greek_fort_gateway_e_piece02_destruct01	rigidmodels/buildings/textures	battle_building
greek_fort_gateway_e_piece02_destruct02	rigidmodels/buildings/textures	battle_building
greek_fort_gateway_e_temp_piece01_destruct01	rigidmodels/buildings/textures	battle_building
greek_fort_gateway_e_temp_piece01_destruct02	rigidmodels/buildings/textures	battle_building
greek_fort_gateway_e_temp_piece02_destruct01	rigidmodels/buildings/textures	battle_building
greek_fort_gateway_e_temp_piece02_destruct02	rigidmodels/buildings/textures	battle_building
greek_fort_internal_angled_to_grid_joiner_piece01_destruct01	rigidmodels/buildings/textures	battle_building
greek_fort_internal_corner_piece01_destruct01	rigidmodels/buildings/textures	battle_building
greek_fort_internal_grid_to_angled_joiner_piece01_destruct01	rigidmodels/buildings/textures	battle_building
greek_fort_straight_e3_piece01_destruct01	rigidmodels/buildings/textures	battle_building
greek_fort_straight_e3_piece01_destruct02	rigidmodels/buildings/textures	battle_building
greek_fort_straight_e3_piece01_destruct03	rigidmodels/buildings/textures	battle_building
greek_fort_straight_piece01_destruct01	rigidmodels/buildings/textures	battle_building
greek_fort_straight_piece01_destruct02	rigidmodels/buildings/textures	battle_building
greek_fort_straight_piece01_destruct03	rigidmodels/buildings/textures	battle_building
greek_fort_straight_stepped_down_10m_square_bastion_a_piece01_destruct01	rigidmodels/buildings/textures	battle_building
greek_fort_straight_stepped_up_10m_square_bastion_a_piece01_destruct01	rigidmodels/buildings/textures	battle_building
greek_fort_straight_temp_piece01_destruct01	rigidmodels/buildings/textures	battle_building
greek_fort_straight_temp_piece01_destruct02	rigidmodels/buildings/textures	battle_building
greek_fort_straight_temp_piece01_destruct03	rigidmodels/buildings/textures	battle_building
greek_fort_straight_with_doors_a_piece01_destruct01	rigidmodels/buildings/textures	battle_building
greek_fort_straight_with_doors_a_piece01_destruct02	rigidmodels/buildings/textures	battle_building
greek_fort_straight_with_doors_a_piece01_destruct03	rigidmodels/buildings/textures	battle_building
greek_fort_straight_with_doors_a_temp_piece01_destruct01	rigidmodels/buildings/textures	battle_building
greek_fort_straight_with_doors_a_temp_piece01_destruct02	rigidmodels/buildings/textures	battle_building
greek_fort_straight_with_doors_a_temp_piece01_destruct03	rigidmodels/buildings/textures	battle_building
greek_fort_straight_with_solid_squared_bastion_piece01_destruct01	rigidmodels/buildings/textures	battle_building
greek_fort_straight_with_solid_squared_bastion_piece01_destruct02	rigidmodels/buildings/textures	battle_building
greek_fort_tower_b_corner_with_extension_piece01_destruct01	rigidmodels/buildings/textures	battle_building
greek_fort_tower_c_straight_with_extension_30fps_piece01_destruct01	rigidmodels/buildings/textures	battle_building
greek_fort_tower_c_straight_with_extension_30fps_piece01_destruct02	rigidmodels/buildings/textures	battle_building
greek_fort_tower_c_straight_with_extension_piece01_destruct01	rigidmodels/buildings/textures	battle_building
greek_fort_tower_c_straight_with_extension_piece01_destruct02	rigidmodels/buildings/textures	battle_building
greek_fort_tower_end_left_piece01_destruct01	rigidmodels/buildings/textures	battle_building
greek_fort_tower_end_right_piece01_destruct01	rigidmodels/buildings/textures	battle_building
greek_freestanding_canopy_a_piece01_destruct01	rigidmodels/buildings/textures	battle_building
greek_freestanding_canopy_b_piece01_destruct01	rigidmodels/buildings/textures	battle_building
greek_gate_20m_01_piece03_destruct01	rigidmodels/buildings/textures	battle_building
greek_large_statue_broken_empty_piece01_destruct01	rigidmodels/buildings/textures	battle_building
greek_large_statue_broken_piece01_destruct01	rigidmodels/buildings/textures	battle_building
greek_pillar_wall_8m_piece01_destruct01	rigidmodels/buildings/textures	battle_building
greek_pillar_wall_corner_piece01_destruct01	rigidmodels/buildings/textures	battle_building
greek_pillar_wall_end_piece01_destruct01	rigidmodels/buildings/textures	battle_building
greek_small_domestic_1_piece01_destruct01	rigidmodels/buildings/textures	battle_building
greek_small_domestic_1_piece01_destruct02	rigidmodels/buildings/textures	battle_building
greek_small_domestic_1_piece01_destruct03	rigidmodels/buildings/textures	battle_building
greek_small_domestic_2_piece01_destruct01	rigidmodels/buildings/textures	battle_building
greek_small_domestic_2_piece01_destruct02	rigidmodels/buildings/textures	battle_building
greek_small_domestic_2_piece01_destruct03	rigidmodels/buildings/textures	battle_building
greek_small_domestic_3_piece01_destruct01	rigidmodels/buildings/textures	battle_building
greek_small_domestic_4_piece01_destruct01	rigidmodels/buildings/textures	battle_building
greek_small_domestic_5_piece01_destruct01	rigidmodels/buildings/textures	battle_building
greek_small_domestic_6_piece01_destruct01	rigidmodels/buildings/textures	battle_building
greek_small_domestic_7_piece01_destruct01	rigidmodels/buildings/textures	battle_building
greek_small_domestic_8_piece01_destruct01	rigidmodels/buildings/textures	battle_building
greek_small_domestic_9_piece01_destruct01	rigidmodels/buildings/textures	battle_building
greek_statue_augustus_large_piece01_destruct01	rigidmodels/buildings/textures	battle_building
greek_statue_augustus_piece01_destruct01	rigidmodels/buildings/textures	battle_building
greek_statue_broken_empty_piece01_destruct01	rigidmodels/buildings/textures	battle_building
greek_statue_broken_piece01_destruct01	rigidmodels/buildings/textures	battle_building
greek_statue_hera_large_piece01_destruct01	rigidmodels/buildings/textures	battle_building
greek_statue_hera_piece01_destruct01	rigidmodels/buildings/textures	battle_building
greek_statue_poseidon_large_piece01_destruct01	rigidmodels/buildings/textures	battle_building
greek_torch_sconce_piece01_destruct01	rigidmodels/buildings/textures	battle_building
greek_tower_20m_01_piece02_destruct01	rigidmodels/buildings/textures	battle_building
greek_wall_20m_01_low_piece04_destruct01	rigidmodels/buildings/textures	battle_building
greek_wall_20m_01_medium_piece05_destruct01	rigidmodels/buildings/textures	battle_building
greek_wall_siegeladder_piece11_destruct01	rigidmodels/buildings/textures	battle_building
greek_wall_siegetower_piece12_destruct01	rigidmodels/buildings/textures	battle_building
half_cylinder_building01_piece01_destruct01	rigidmodels/buildings/textures	battle_building
hedge_small_1_piece01_destruct01	RigidModels\BattleFieldProps\Textures	battle_misc
hedge_small_2_piece01_destruct01	RigidModels\BattleFieldProps\Textures	battle_misc
hedge_small_4_piece01_destruct01	RigidModels\BattleFieldProps\Textures	battle_misc
hedge_small_8_piece01_destruct01	RigidModels\BattleFieldProps\Textures	battle_misc
hedge_small_end_piece01_destruct01	RigidModels\BattleFieldProps\Textures	battle_misc
hedge_small_piece01_destruct01	RigidModels\BattleFieldProps\Textures	battle_misc
hedge_winter_small_1_piece01_destruct01	RigidModels\BattleFieldProps\Textures\Winter	battle_misc
hedge_winter_small_2_piece01_destruct01	RigidModels\BattleFieldProps\Textures\Winter	battle_misc
hedge_winter_small_4_piece01_destruct01	RigidModels\BattleFieldProps\Textures\Winter	battle_misc
hedge_winter_small_8_piece01_destruct01	RigidModels\BattleFieldProps\Textures\Winter	battle_misc
hedge_winter_small_end_piece01_destruct01	RigidModels\BattleFieldProps\Textures\Winter	battle_misc
hedge_winter_small_piece01_destruct01	RigidModels\BattleFieldProps\Textures\Winter	battle_misc
hills01_a	RigidModels\outfield\terrain\textures	battle_misc
hills01_b	RigidModels\outfield\terrain\textures	battle_misc
hills01_c	RigidModels\outfield\terrain\textures	battle_misc
hills01_d	RigidModels\outfield\terrain\textures	battle_misc
hills02_a	RigidModels\outfield\terrain\textures	battle_misc
hills02_b	RigidModels\outfield\terrain\textures	battle_misc
hills02_c	RigidModels\outfield\terrain\textures	battle_misc
hills02_d	RigidModels\outfield\terrain\textures	battle_misc
hills03_a	RigidModels\outfield\terrain\textures	battle_misc
hills03_b	RigidModels\outfield\terrain\textures	battle_misc
hills03_c	RigidModels\outfield\terrain\textures	battle_misc
hills03_d	RigidModels\outfield\terrain\textures	battle_misc
hippodrome_building_piece01_destruct01	rigidmodels/buildings/textures	battle_building
hippodrome_foundation_piece01_destruct01	rigidmodels/buildings/textures	battle_building
hippodrome_piece01_destruct01	rigidmodels/buildings/textures	battle_building
hippodrome_plinth_piece01_destruct01	rigidmodels/buildings/textures	battle_building
hippodrome_shade_piece01_destruct01	rigidmodels/buildings/textures	battle_building
hippodrome_triple_arch_piece01_destruct01	rigidmodels/buildings/textures	battle_building
icon_can_construct	RigidModels/Flags/Textures/	campaign_template_extra
icon_port_blockade	RigidModels/CampaignBuildings/Textures/	campaign_building
icon_raiding	RigidModels/Flags/Textures/	campaign_template_extra
icon_trading	RigidModels/Flags/Textures/	campaign_template_extra
impassible_marker	RigidModels\WarscapeFrame\ai_hints\Textures	3Dindicators
infantry_proxy	RigidModels/UI/Textures	3Dindicators
islands01_a	RigidModels\outfield\terrain\textures	battle_misc
islands01_b	RigidModels\outfield\terrain\textures	battle_misc
islands01_c	RigidModels\outfield\terrain\textures	battle_misc
islands01_d	RigidModels\outfield\terrain\textures	battle_misc
l_paving_block_piece01_destruct01	rigidmodels/buildings/textures	battle_building
lantern_paper_big_b	RigidModels/VerletItems/textures/	battle_building
lantern_paper_big_b_cream	RigidModels/VerletItems/textures/	battle_building
lantern_paper_big_b_red	RigidModels/VerletItems/textures/	battle_building
large_arch_piece01_destruct01	rigidmodels/buildings/textures	battle_building
large_curved_building_piece01_destruct01	rigidmodels/buildings/textures	battle_building
large_flat_square_building_piece01_destruct01	rigidmodels/buildings/textures	battle_building
large_l_buildings_piece01_destruct01	rigidmodels/buildings/textures	battle_building
large_log_dry_piece01_destruct01	RigidModels\Buildings\AAA_TEXTURES	battle_building
large_log_piece01_destruct01	RigidModels\Buildings\AAA_TEXTURES	battle_building
large_long_building_piece01_destruct01	rigidmodels/buildings/textures	battle_building
large_pink_square_building_piece01_destruct01	rigidmodels/buildings/textures	battle_building
large_rectangle_flat_roof_piece01_destruct01	rigidmodels/buildings/textures	battle_building
large_roof_building_block_piece01_destruct01	rigidmodels/buildings/textures	battle_building
large_roof_tower_building_piece01_destruct01	rigidmodels/buildings/textures	battle_building
large_sloping_roof_building_piece01_destruct01	rigidmodels/buildings/textures	battle_building
large_square_roof_building_piece01_destruct01	rigidmodels/buildings/textures	battle_building
large_statue_piece01_destruct01	rigidmodels/buildings/textures	battle_building
large_tall_pink_tower_piece01_destruct01	rigidmodels/buildings/textures	battle_building
large_town_buildings01_piece01_destruct01	rigidmodels/buildings/textures	battle_building
large_town_buildings02_piece01_destruct01	rigidmodels/buildings/textures	battle_building
large_triangle_building_piece01_destruct01	rigidmodels/buildings/textures	battle_building
low_block_building_piece01_destruct01	rigidmodels/buildings/textures	battle_building
mangonel_destruction_model	RigidModels/artillery/Textures	battle_misc
market_stall_fish_market_piece01_destruct01	rigidmodels/buildings/textures	battle_building
market_stall_fruit_market_piece01_destruct01	rigidmodels/buildings/textures	battle_building
market_stall_pottery_market_piece01_destruct01	rigidmodels/buildings/textures	battle_building
mausauleum_building_piece01_destruct01	rigidmodels/buildings/textures	battle_building
mausauleum_piece01_destruct01	rigidmodels/buildings/textures	battle_building
mausauleum_steps_piece01_destruct01	rigidmodels/buildings/textures	battle_building
mausauleum_wall_piece01_destruct01	rigidmodels/buildings/textures	battle_building
medium_courtyard_building_piece01_destruct01	rigidmodels/buildings/textures	battle_building
medium_cylindrical_building_piece01_destruct01	rigidmodels/buildings/textures	battle_building
medium_double_block_piece01_destruct01	rigidmodels/buildings/textures	battle_building
medium_garden_courtyard_piece01_destruct01	rigidmodels/buildings/textures	battle_building
medium_log_dry_piece01_destruct01	RigidModels\Buildings\AAA_TEXTURES	battle_building
medium_log_piece01_destruct01	RigidModels\Buildings\AAA_TEXTURES	battle_building
medium_long_building_piece01_destruct01	rigidmodels/buildings/textures	battle_building
medium_small_long_building_piece01_destruct01	rigidmodels/buildings/textures	battle_building
medium_temple_piece01_destruct01	rigidmodels/buildings/textures	battle_building
medium_tower_building_piece01_destruct01	rigidmodels/buildings/textures	battle_building
medium_town_buildings01_piece01_destruct01	rigidmodels/buildings/textures	battle_building
medium_town_buildings02_piece01_destruct01	rigidmodels/buildings/textures	battle_building
medium_triple_arch_piece01_destruct01	rigidmodels/buildings/textures	battle_building
medium_u_foundation_piece01_destruct01	rigidmodels/buildings/textures	battle_building
medium_z_buildings_piece01_destruct01	rigidmodels/buildings/textures	battle_building
modular_temple_balcony_corner_piece01_destruct01	rigidmodels/buildings/textures	battle_building
modular_temple_balcony_piece01_destruct01	rigidmodels/buildings/textures	battle_building
modular_temple_door_piece01_destruct01	rigidmodels/buildings/textures	battle_building
modular_temple_floor_2x2m_piece01_destruct01	rigidmodels/buildings/textures	battle_building
modular_temple_floor_4x4m_piece01_destruct01	rigidmodels/buildings/textures	battle_building
modular_temple_floor_8x8m_piece01_destruct01	rigidmodels/buildings/textures	battle_building
modular_temple_floor_curved_piece01_destruct01	rigidmodels/buildings/textures	battle_building
modular_temple_floor_piece01_destruct01	rigidmodels/buildings/textures	battle_building
modular_temple_pillar_piece01_destruct01	rigidmodels/buildings/textures	battle_building
modular_temple_pillar_small_piece01_destruct01	rigidmodels/buildings/textures	battle_building
modular_temple_roof_corner_piece01_destruct01	rigidmodels/buildings/textures	battle_building
modular_temple_roof_end_piece01_destruct01	rigidmodels/buildings/textures	battle_building
modular_temple_roof_half_piece01_destruct01	rigidmodels/buildings/textures	battle_building
modular_temple_roof_massive_end_piece01_destruct01	rigidmodels/buildings/textures	battle_building
modular_temple_roof_massive_middle_piece01_destruct01	rigidmodels/buildings/textures	battle_building
modular_temple_roof_middle_piece01_destruct01	rigidmodels/buildings/textures	battle_building
modular_temple_roof_round_piece01_destruct01	rigidmodels/buildings/textures	battle_building
modular_temple_room_half_piece01_destruct01	rigidmodels/buildings/textures	battle_building
modular_temple_room_piece01_destruct01	rigidmodels/buildings/textures	battle_building
modular_temple_room_round_piece01_destruct01	rigidmodels/buildings/textures	battle_building
modular_temple_square_pillar_piece01_destruct01	rigidmodels/buildings/textures	battle_building
modular_temple_stairs_enterance_piece01_destruct01	rigidmodels/buildings/textures	battle_building
modular_temple_stairs_half_piece01_destruct01	rigidmodels/buildings/textures	battle_building
modular_temple_stairs_piece01_destruct01	rigidmodels/buildings/textures	battle_building
modular_temple_stairs_round_piece01_destruct01	rigidmodels/buildings/textures	battle_building
modular_temple_wall_corner_piece01_destruct01	rigidmodels/buildings/textures	battle_building
modular_temple_wall_end_piece01_destruct01	rigidmodels/buildings/textures	battle_building
modular_temple_wall_long_16m_piece01_destruct01	rigidmodels/buildings/textures	battle_building
modular_temple_wall_pannel_arch_piece01_destruct01	rigidmodels/buildings/textures	battle_building
modular_temple_wall_pannel_piece01_destruct01	rigidmodels/buildings/textures	battle_building
modular_temple_wall_pannel_pillars_piece01_destruct01	rigidmodels/buildings/textures	battle_building
modular_temple_wall_pannel_windows_piece01_destruct01	rigidmodels/buildings/textures	battle_building
modular_temple_wall_small_8m_piece01_destruct01	rigidmodels/buildings/textures	battle_building
modular_temple_window_piece01_destruct01	rigidmodels/buildings/textures	battle_building
modular_terrace_ext_corner_left_piece01_destruct01	rigidmodels/buildings/textures	battle_building
modular_terrace_ext_corner_right_piece01_destruct01	rigidmodels/buildings/textures	battle_building
modular_terrace_int_corner_left_piece01_destruct01	rigidmodels/buildings/textures	battle_building
modular_terrace_int_corner_right_piece01_destruct01	rigidmodels/buildings/textures	battle_building
modular_terrace_pavement_top_of_steps_piece01_destruct01	rigidmodels/buildings/textures	battle_building
modular_terrace_pavement_wings_piece01_destruct01	rigidmodels/buildings/textures	battle_building
modular_terrace_steps_bannister_left_piece01_destruct01	rigidmodels/buildings/textures	battle_building
modular_terrace_steps_bannister_right_piece01_destruct01	rigidmodels/buildings/textures	battle_building
modular_terrace_steps_landing_piece01_destruct01	rigidmodels/buildings/textures	battle_building
modular_terrace_steps_medium_gradient_piece01_destruct01	rigidmodels/buildings/textures	battle_building
modular_terrace_wall_10m_wide_piece01_destruct01	rigidmodels/buildings/textures	battle_building
mountains_a	RigidModels\outfield\terrain\textures	battle_misc
mountains_b	RigidModels\outfield\terrain\textures	battle_misc
mountains_c	RigidModels\outfield\terrain\textures	battle_misc
mountains_d	RigidModels\outfield\terrain\textures	battle_misc
muzzle_flash	RigidModels/Projectile/Textures	projectiles
nap_eur_port_slot	RigidModels/CampaignBuildings/Textures/	campaign_template
nap_eur_town_com_slot	RigidModels/CampaignBuildings/Textures/	campaign_template
nap_eur_town_edu_slot	RigidModels/CampaignBuildings/Textures/	campaign_template
no_moves_ring	RigidModels\3DIndicators\Textures	3Dindicators
north_euro_hut03_v02_piece01_destruct01	RigidModels\Buildings\AAA_TEXTURES	battle_building
north_euro_rural04_destruct01	RigidModels\Buildings\AAA_TEXTURES	battle_building
north_euro_rural04_destruct02	RigidModels\Buildings\AAA_TEXTURES	battle_building
oblock_building_piece01_destruct01	rigidmodels/buildings/textures	battle_building
observation_balloon	RigidModels\BattleFieldProps\Textures	battle_misc
occupiable_building	RigidModels\3DIndicators\Textures	3Dindicators
oodateshield_piece01_destruct01_lod01	RigidModels/DeployableItems/Textures/OodateShield	battle_misc
plains_a	RigidModels\outfield\terrain\textures	battle_misc
plains_b	RigidModels\outfield\terrain\textures	battle_misc
plains_c	RigidModels\outfield\terrain\textures	battle_misc
plains_d	RigidModels\outfield\terrain\textures	battle_misc
pontoon_01_extender_piece01_destruct01	rigidmodels/buildings/textures	battle_building
pontoon_01_piece01_destruct01	rigidmodels/buildings/textures	battle_building
pontoon_02_high_extender_piece01_destruct01	rigidmodels/buildings/textures	battle_building
pontoon_02_high_piece01_destruct01	rigidmodels/buildings/textures	battle_building
pontoon_03_flat_extender_piece01_destruct01	rigidmodels/buildings/textures	battle_building
pontoon_03_flat_piece01_destruct01	rigidmodels/buildings/textures	battle_building
pontoon_04_dock_a_piece01_destruct01	rigidmodels/buildings/textures	battle_building
pontoon_04_dock_b_piece01_destruct01	rigidmodels/buildings/textures	battle_building
pontoon_04_dock_c_piece01_destruct01	rigidmodels/buildings/textures	battle_building
pontoon_wrecked_a_piece01_destruct01	rigidmodels/buildings/textures	battle_building
pontoon_wrecked_a_piece01_destruct02	rigidmodels/buildings/textures	battle_building
pontoon_wrecked_b_piece01_destruct01	rigidmodels/buildings/textures	battle_building
pontoon_wrecked_b_piece01_destruct02	rigidmodels/buildings/textures	battle_building
pontoon_wrecked_c_piece01_destruct01	rigidmodels/buildings/textures	battle_building
pontoon_wrecked_c_piece01_destruct02	rigidmodels/buildings/textures	battle_building
pool_building_piece01_destruct01	rigidmodels/buildings/textures	battle_building
porch_roofed_piece01_destruct01	rigidmodels/buildings/textures	battle_building
positional_bigrailA_L01	RigidModels/Naval/Textures	ship_variant
positional_capstanA_L01	RigidModels/Naval/Textures	ship_variant
positional_capstanA_L02	RigidModels/Naval/Textures	ship_variant
positional_figurehead_L01	RigidModels/Naval/Textures	ship_variant
positional_lanternA_L01	RigidModels/Naval/Textures	ship_variant
positional_lanternA_L02	RigidModels/Naval/Textures	ship_variant
positional_oar_L01	RigidModels/Naval/Textures	ship_variant
positional_oar_L02	RigidModels/Naval/Textures	ship_variant
positional_oar_L03	RigidModels/Naval/Textures	ship_variant
positional_postsA_L01	RigidModels/Naval/Textures	ship_variant
positional_sparA_L01	RigidModels/Naval/Textures	ship_variant
positional_sparA_L02	RigidModels/Naval/Textures	ship_variant
positional_wheelA_L01	RigidModels/Naval/Textures	ship_variant
prestige_ajinkyatara	RigidModels/CampaignBuildings/Textures	campaign_building
prestige_albertina	RigidModels/CampaignBuildings/Textures	campaign_building
prestige_britishmuseum	RigidModels/CampaignBuildings/Textures	campaign_building
prestige_independancehall	RigidModels/CampaignBuildings/Textures	campaign_building
prestige_konikjlijke	RigidModels/CampaignBuildings/Textures	campaign_building
prestige_realacademia	RigidModels/CampaignBuildings/Textures	campaign_building
prestige_shaniwarwada	RigidModels/CampaignBuildings/Textures	campaign_building
prestige_smithsonian	RigidModels/CampaignBuildings/Textures	campaign_building
prestige_stockholmslott	RigidModels/CampaignBuildings/Textures	campaign_building
projectile_animal_carcass_debris	RigidModels/Projectiles	projectiles
projectile_arrow	VariantMeshes/_VariantModels/man/weapons/tex	projectiles
projectile_deer_carcass	RigidModels/Projectiles/Textures	projectiles
projectile_fireball	rigidModels\projectiles/textures	battle_projectile
projectile_fragment01	RigidModels/Projectile/empire_projectile_tex	projectiles
projectile_harpax	RigidModels/Projectiles/textures/	projectiles
projectile_javelin	VariantMeshes/_VariantModels/man/weapons/tex	projectiles
projectile_mangonel	VariantModels/Equipment	projectiles
projectile_pilum	VariantMeshes/_VariantModels/man/weapons/tex	projectiles
projectile_pilum_heavy	VariantMeshes/_VariantModels/man/weapons/tex	projectiles
projectile_pilum_iron	VariantMeshes/_VariantModels/man/weapons/tex	projectiles
projectile_pilum_light	VariantMeshes/_VariantModels/man/weapons/tex	projectiles
projectile_torch	VariantMeshes/_VariantModels/man/weapons	projectiles
projectiles_arrow_barbarian	VariantMeshes/_VariantModels/man/weapons/tex	projectiles
projectiles_arrow_eastern	VariantMeshes/_VariantModels/man/weapons/tex	projectiles
projectiles_arrow_fire	VariantMeshes/_VariantModels/man/weapons/tex	projectiles
projectiles_arrow_polybolos	rigidModels\projectiles/textures	battle_projectile
projectiles_arrow_roman	VariantMeshes/_VariantModels/man/weapons/tex	projectiles
projectiles_beehvie	rigidModels\projectiles/textures	battle_projectile
projectiles_bolt	rigidModels\projectiles/textures	battle_projectile
projectiles_bolt_large	rigidModels\projectiles/textures	battle_projectile
projectiles_explosive_pot	rigidModels\projectiles/textures	battle_projectile
projectiles_explosive_pot_large	rigidModels\projectiles/textures	battle_projectile
projectiles_rock	rigidModels\projectiles/textures	battle_projectile
projectiles_rock_flammable	rigidModels\projectiles/textures	battle_projectile
projectiles_rock_large	rigidModels\projectiles/textures	battle_projectile
projectiles_rock_large_flammable	rigidModels\projectiles/textures	battle_projectile
projectiles_scorpion_pot	rigidModels\projectiles/textures	battle_projectile
projectiles_sling_shot	rigidModels\projectiles\textures	battle_projectile
projectiles_snake_pot	rigidModels\projectiles/textures	battle_projectile
projectiles_stone	rigidModels\projectiles/textures	battle_projectile
projectiles_stone_brick_large	rigidModels\projectiles/textures	battle_projectile
projectiles_stone_brick_small	rigidModels\projectiles/textures	battle_projectile
projectiles_stone_flammable	rigidModels\projectiles/textures	battle_projectile
projectiles_stone_large	rigidModels\projectiles/textures	battle_projectile
projectiles_stone_large_flammable	rigidModels\projectiles/textures	battle_projectile
proxy_artillery	UI/3DUI/textures/default/	incidental
proxy_cavalry	UI/3DUI/textures/default/	incidental
proxy_facing_arrow	UI/3DUI/textures/default/	incidental
proxy_infantry	UI/3DUI/textures/default/	incidental
rack_fish_drying_piece01_destruct01	rigidmodels/buildings/textures	battle_building
rack_fish_drying_piece01_destruct02	rigidmodels/buildings/textures	battle_building
rack_fish_hanging_piece01_destruct01	rigidmodels/buildings/textures	battle_building
rack_fish_hanging_piece01_destruct02	rigidmodels/buildings/textures	battle_building
redoubt_marker	RigidModels\WarscapeFrame\ai_hints\Textures	3Dindicators
river_sound_emitter_marker	RigidModels\WarscapeFrame\sound_emitters\textures	3Dindicators
rock_1_dry_piece01_destruct01	RigidModels\Buildings\AAA_TEXTURES	battle_building
rock_1_wet_piece01_destruct01	RigidModels\Buildings\AAA_TEXTURES	battle_building
rock_2_dry_piece01_destruct01	RigidModels\Buildings\AAA_TEXTURES	battle_building
rock_2_wet_piece01_destruct01	RigidModels\Buildings\AAA_TEXTURES	battle_building
rock_3_dry_piece01_destruct01	RigidModels\Buildings\AAA_TEXTURES	battle_building
rock_3_wet_piece01_destruct01	RigidModels\Buildings\AAA_TEXTURES	battle_building
rock_4_dry_piece01_destruct01	RigidModels\Buildings\AAA_TEXTURES	battle_building
rock_4_wet_piece01_destruct01	RigidModels\Buildings\AAA_TEXTURES	battle_building
rock_a_piece01_destruct01	rigidmodels/buildings/textures	battle_building
rock_b_piece01_destruct01	rigidmodels/buildings/textures	battle_building
rock_c_piece01_destruct01	rigidmodels/buildings/textures	battle_building
rock_d_piece01_destruct01	rigidmodels/buildings/textures	battle_building
rock_e_piece01_destruct01	rigidmodels/buildings/textures	battle_building
rock_f_piece01_destruct01	rigidmodels/buildings/textures	battle_building
rock_g_piece01_destruct01	rigidmodels/buildings/textures	battle_building
roman_agora_2storey_building01_piece01_destruct01	rigidmodels/buildings/textures	battle_building
roman_agora_2storey_building02_piece01_destruct01	rigidmodels/buildings/textures	battle_building
roman_agora_2storey_building03_piece01_destruct01	rigidmodels/buildings/textures	battle_building
roman_agora_main_segment_end_detailed_flipped_piece01_destruct01	rigidmodels/buildings/textures	battle_building
roman_agora_main_segment_end_detailed_piece01_destruct01	rigidmodels/buildings/textures	battle_building
roman_agora_main_segment_piece01_destruct01	rigidmodels/buildings/textures	battle_building
roman_colonnade_corner_piece01_destruct01	rigidmodels/buildings/textures	battle_building
roman_colonnade_straight_piece01_destruct01	rigidmodels/buildings/textures	battle_building
roman_quinquereme_bow_01_dm1	RigidModels/Naval/Textures	campaign_building
roman_quinquereme_bow_02_dm1	RigidModels/Naval/Textures	campaign_building
roman_quinquereme_mast_01_dm1	RigidModels/Naval/Textures	campaign_building
roman_quinquereme_mast_02_dm1	RigidModels/Naval/Textures	campaign_building
roman_quinquereme_misc_01_dm1	RigidModels/Naval/Textures	campaign_building
roman_quinquereme_port_01_dm1	RigidModels/Naval/Textures	campaign_building
roman_quinquereme_port_02_dm1	RigidModels/Naval/Textures	campaign_building
roman_quinquereme_port_03_dm1	RigidModels/Naval/Textures	campaign_building
roman_quinquereme_port_04_dm1	RigidModels/Naval/Textures	campaign_building
roman_quinquereme_port_05_dm1	RigidModels/Naval/Textures	campaign_building
roman_quinquereme_port_06_dm1	RigidModels/Naval/Textures	campaign_building
roman_quinquereme_starb_01_dm1	RigidModels/Naval/Textures	campaign_building
roman_quinquereme_starb_02_dm1	RigidModels/Naval/Textures	campaign_building
roman_quinquereme_starb_03_dm1	RigidModels/Naval/Textures	campaign_building
roman_quinquereme_starb_04_dm1	RigidModels/Naval/Textures	campaign_building
roman_quinquereme_starb_05_dm1	RigidModels/Naval/Textures	campaign_building
roman_quinquereme_starb_06_dm1	RigidModels/Naval/Textures	campaign_building
roman_quinquereme_stern_01_dm1	RigidModels/Naval/Textures	campaign_building
roman_quinquereme_stern_02_dm1	RigidModels/Naval/Textures	campaign_building
roman_trireme_bow_01_dm1	RigidModels/Naval/Textures	campaign_building
roman_trireme_bow_01_dm2	RigidModels/Naval/Textures	campaign_building
roman_trireme_bow_01_dm3	RigidModels/Naval/Textures	campaign_building
roman_trireme_bow_02_dm1	RigidModels/Naval/Textures	campaign_building
roman_trireme_bow_02_dm2	RigidModels/Naval/Textures	campaign_building
roman_trireme_bow_02_dm3	RigidModels/Naval/Textures	campaign_building
roman_trireme_bow_03_dm1	RigidModels/Naval/Textures	campaign_building
roman_trireme_bow_03_dm2	RigidModels/Naval/Textures	campaign_building
roman_trireme_bow_03_dm3	RigidModels/Naval/Textures	campaign_building
roman_trireme_mast_01_dm1	RigidModels/Naval/Textures	campaign_building
roman_trireme_mast_02_dm1	RigidModels/Naval/Textures	campaign_building
roman_trireme_misc_01_dm1	RigidModels/Naval/Textures	campaign_building
roman_trireme_misc_01_dm2	RigidModels/Naval/Textures	campaign_building
roman_trireme_misc_01_dm3	RigidModels/Naval/Textures	campaign_building
roman_trireme_port_01_dm1	RigidModels/Naval/Textures	campaign_building
roman_trireme_port_01_dm2	RigidModels/Naval/Textures	campaign_building
roman_trireme_port_01_dm3	RigidModels/Naval/Textures	campaign_building
roman_trireme_port_02_dm1	RigidModels/Naval/Textures	campaign_building
roman_trireme_port_02_dm2	RigidModels/Naval/Textures	campaign_building
roman_trireme_port_02_dm3	RigidModels/Naval/Textures	campaign_building
roman_trireme_port_03_dm1	RigidModels/Naval/Textures	campaign_building
roman_trireme_port_03_dm2	RigidModels/Naval/Textures	campaign_building
roman_trireme_port_03_dm3	RigidModels/Naval/Textures	campaign_building
roman_trireme_port_04_dm1	RigidModels/Naval/Textures	campaign_building
roman_trireme_port_04_dm2	RigidModels/Naval/Textures	campaign_building
roman_trireme_port_04_dm3	RigidModels/Naval/Textures	campaign_building
roman_trireme_port_05_dm1	RigidModels/Naval/Textures	campaign_building
roman_trireme_port_05_dm2	RigidModels/Naval/Textures	campaign_building
roman_trireme_port_05_dm3	RigidModels/Naval/Textures	campaign_building
roman_trireme_starb_01_dm1	RigidModels/Naval/Textures	campaign_building
roman_trireme_starb_01_dm2	RigidModels/Naval/Textures	campaign_building
roman_trireme_starb_01_dm3	RigidModels/Naval/Textures	campaign_building
roman_trireme_starb_02_dm1	RigidModels/Naval/Textures	campaign_building
roman_trireme_starb_02_dm2	RigidModels/Naval/Textures	campaign_building
roman_trireme_starb_02_dm3	RigidModels/Naval/Textures	campaign_building
roman_trireme_starb_03_dm1	RigidModels/Naval/Textures	campaign_building
roman_trireme_starb_03_dm2	RigidModels/Naval/Textures	campaign_building
roman_trireme_starb_03_dm3	RigidModels/Naval/Textures	campaign_building
roman_trireme_starb_04_dm1	RigidModels/Naval/Textures	campaign_building
roman_trireme_starb_04_dm2	RigidModels/Naval/Textures	campaign_building
roman_trireme_starb_04_dm3	RigidModels/Naval/Textures	campaign_building
roman_trireme_starb_05_dm1	RigidModels/Naval/Textures	campaign_building
roman_trireme_starb_05_dm2	RigidModels/Naval/Textures	campaign_building
roman_trireme_starb_05_dm3	RigidModels/Naval/Textures	campaign_building
roman_trireme_stern_01_dm1	RigidModels/Naval/Textures	campaign_building
roman_trireme_stern_01_dm2	RigidModels/Naval/Textures	campaign_building
roman_trireme_stern_01_dm3	RigidModels/Naval/Textures	campaign_building
roman_trireme_stern_02_dm1	RigidModels/Naval/Textures	campaign_building
roman_trireme_stern_02_dm2	RigidModels/Naval/Textures	campaign_building
roman_trireme_stern_02_dm3	RigidModels/Naval/Textures	campaign_building
rome_ballista_giant_destroyed	RigidModels/buildings/textures	battle_misc
rome_ballista_medium_destroyed	RigidModels/buildings/textures	battle_misc
rome_ballista_medium_ship_destroyed	RigidModels/buildings/textures	battle_misc
rome_cheiroballistra_destroyed	RigidModels/buildings/textures	battle_misc
rome_fireraiser_destroyed	RigidModels/buildings/textures	battle_misc
rome_harpax_destroyed	RigidModels/buildings/textures	battle_misc
rome_onager_destroyed	RigidModels/buildings/textures	battle_misc
rome_onager_large_destroyed	RigidModels/buildings/textures	battle_misc
rome_onager_ship_destroyed	RigidModels/buildings/textures	battle_misc
rome_polybolos_destroyed	RigidModels/buildings/textures	battle_misc
rome_scorpio_destroyed	RigidModels/buildings/textures	battle_misc
roof_corner_piece01_destruct01	rigidmodels/buildings/textures	battle_building
roof_raised_house_piece01_destruct01	rigidmodels/buildings/textures	battle_building
roof_straight_piece01_destruct01	rigidmodels/buildings/textures	battle_building
roofed_wall_piece01_destruct01	rigidmodels/buildings/textures	battle_building
ruin_columns_1_piece01_destruct01	rigidmodels/buildings/textures	battle_building
ruin_columns_2_piece01_destruct01	rigidmodels/buildings/textures	battle_building
ruin_columns_3_piece01_destruct01	rigidmodels/buildings/textures	battle_building
ruin_columns_4_piece01_destruct01	rigidmodels/buildings/textures	battle_building
ruin_columns_5_piece01_destruct01	rigidmodels/buildings/textures	battle_building
ruin_floor_1_piece01_destruct01	rigidmodels/buildings/textures	battle_building
ruin_floor_1_piece02_destruct01	rigidmodels/buildings/textures	battle_building
ruin_floor_1_piece03_destruct01	rigidmodels/buildings/textures	battle_building
ruin_floor_1_piece04_destruct01	rigidmodels/buildings/textures	battle_building
ruin_floor_2_piece01_destruct01	rigidmodels/buildings/textures	battle_building
ruin_floor_3_piece01_destruct01	rigidmodels/buildings/textures	battle_building
ruin_rubble_1_piece01_destruct01	rigidmodels/buildings/textures	battle_building
ruin_rubble_2_piece01_destruct01	rigidmodels/buildings/textures	battle_building
ruin_single_column_1_piece01_destruct01	rigidmodels/buildings/textures	battle_building
ruin_single_column_2_piece01_destruct01	rigidmodels/buildings/textures	battle_building
ruin_single_column_3_piece01_destruct01	rigidmodels/buildings/textures	battle_building
ruin_single_column_4_piece01_destruct01	rigidmodels/buildings/textures	battle_building
sPrest_austria_heldenplatz	RigidModels/CampaignBuildings/Textures	campaign_building
sPrest_austria_theatrewein	RigidModels/CampaignBuildings/Textures	campaign_building
sPrest_britain_nationalgallery	RigidModels/CampaignBuildings/Textures	campaign_building
sPrest_britain_nelson	RigidModels/CampaignBuildings/Textures	campaign_building
sPrest_france_arcdetriomphe	RigidModels/CampaignBuildings/Textures	campaign_building
sPrest_france_museenapoleon	RigidModels/CampaignBuildings/Textures	campaign_building
sPrest_prussia_humboldt	RigidModels/CampaignBuildings/Textures	campaign_building
sPrest_prussia_victorycolumn	RigidModels/CampaignBuildings/Textures	campaign_building
sPrest_russia_kremlinarmoury	RigidModels/CampaignBuildings/Textures	campaign_building
sPrest_russia_monumentminin	RigidModels/CampaignBuildings/Textures	campaign_building
sambuca_piece01_destruct01	rigidmodels/buildings/textures	battle_building
scaffolding_tall_01_piece01_destruct01	rigidmodels/buildings/textures	battle_building
scaffolding_tall_02_piece01_destruct01	rigidmodels/buildings/textures	battle_building
sengoku_bune_bow_01_dm1	RigidModels/Naval/Textures	campaign_building
sengoku_bune_hull_01_dm1	RigidModels/Naval/Textures	campaign_building
sengoku_bune_port_01_dm1	RigidModels/Naval/Textures	campaign_building
sengoku_bune_starb_01_dm1	RigidModels/Naval/Textures	campaign_building
sengoku_bune_stern_01_dm1	RigidModels/Naval/Textures	campaign_building
settlement_damage_lvl1	RigidModels/CampaignBuildings/Textures	campaign_building
settlement_damage_lvl2	RigidModels/CampaignBuildings/Textures	campaign_building
settlement_damage_lvl3	RigidModels/CampaignBuildings/Textures	campaign_building
settlement_damage_lvl4	RigidModels/CampaignBuildings/Textures	campaign_building
settlement_damage_lvl5	RigidModels/CampaignBuildings/Textures	campaign_building
sho_agent_icon_geisha	RigidModels/Flags/Textures/agent_geisha	campaign_template_extra
sho_agent_icon_metsuke	RigidModels/Flags/Textures/agent_metsuke	campaign_template_extra
sho_agent_icon_missionary	RigidModels/Flags/Textures/agent_missionary	campaign_template_extra
sho_agent_icon_monk	RigidModels/Flags/Textures/agent_monk	campaign_template_extra
sho_agent_icon_ninja	RigidModels/Flags/Textures/agent_ninja	campaign_template_extra
sho_cha_general_star	RigidModels/Flags/Textures	campaign_template_extra
sho_char_flag	RigidModels/Flags/Textures/	incidental
sho_char_flag_chosokabe	RigidModels\Flags\Textures	campaign_template_extra
sho_char_flag_date	RigidModels\Flags\Textures	campaign_template_extra
sho_char_flag_decorator_faction_leader	RigidModels\Flags\Textures	campaign_template_extra
sho_char_flag_decorator_family	RigidModels\Flags\Textures	campaign_template_extra
sho_char_flag_generic1	RigidModels\Flags\Textures	campaign_template_extra
sho_char_flag_generic2	RigidModels\Flags\Textures	campaign_template_extra
sho_char_flag_hojo	RigidModels\Flags\Textures	campaign_template_extra
sho_char_flag_iga_ninja	RigidModels\Flags\Textures	campaign_template_extra
sho_char_flag_ikko_ikki	RigidModels\Flags\Textures	campaign_template_extra
sho_char_flag_morale	RigidModels/Flags/Textures/	incidental
sho_char_flag_mori	RigidModels\Flags\Textures	campaign_template_extra
sho_char_flag_naval	RigidModels/Flags/Textures/	incidental
sho_char_flag_naval_battle	RigidModels\Flags\Textures	battle_misc
sho_char_flag_naval_hull_damage	RigidModels/Flags/Textures/	incidental
sho_char_flag_naval_saildamage	RigidModels/Flags/Textures/	incidental
sho_char_flag_navy	RigidModels\Flags\Textures	campaign_template_extra
sho_char_flag_oda	RigidModels\Flags\Textures	campaign_template_extra
sho_char_flag_shimazu	RigidModels\Flags\Textures	campaign_template_extra
sho_char_flag_takeda	RigidModels\Flags\Textures	campaign_template_extra
sho_char_flag_tokugawa	RigidModels\Flags\Textures	campaign_template_extra
sho_char_flag_uesugi	RigidModels\Flags\Textures	campaign_template_extra
sho_char_flagpole	RigidModels/Flags/Textures	campaign_template_extra
sho_char_flagpole_battle	RigidModels/Flags/Textures/	incidental
sho_char_flagpole_naval	RigidModels/Flags/Textures/	incidental
sho_char_flagpole_naval_battle	RigidModels/Flags/Textures/	incidental
sho_char_general_star	RigidModels/Flags/Textures	campaign_template_extra
sho_city_castle_construction_lvl1	RigidModels/CampaignBuildings/Textures/	campaign_building
sho_city_castle_construction_lvl2	RigidModels/CampaignBuildings/Textures/	campaign_building
sho_city_castle_construction_lvl3	RigidModels/CampaignBuildings/Textures/	campaign_building
sho_city_castle_construction_lvl4	RigidModels/CampaignBuildings/Textures/	campaign_building
sho_city_castle_construction_lvl5	RigidModels/CampaignBuildings/Textures/	campaign_building
sho_city_settlement_construction_lvl1	RigidModels/CampaignBuildings/Textures/	campaign_building
sho_city_settlement_construction_lvl2	RigidModels/CampaignBuildings/Textures/	campaign_building
sho_city_settlement_construction_lvl3	RigidModels/CampaignBuildings/Textures/	campaign_building
sho_city_settlement_construction_lvl4	RigidModels/CampaignBuildings/Textures/	campaign_building
sho_city_settlement_construction_lvl5	RigidModels/CampaignBuildings/Textures/	campaign_building
sho_port_large_construction	RigidModels/CampaignBuildings/Textures/	campaign_building
sho_port_small_construction	RigidModels/CampaignBuildings/Textures/	campaign_building
sho_reigion_large_construction	RigidModels/CampaignBuildings/Textures/	campaign_building
sho_reigion_medium_construction	RigidModels/CampaignBuildings/Textures/	campaign_building
sho_reigion_small_construction	RigidModels/CampaignBuildings/Textures/	campaign_building
siege_barricade_concav_piece01_destruct01	rigidmodels/buildings/textures	battle_building
siege_barricade_convex_piece01_destruct01	rigidmodels/buildings/textures	battle_building
siege_barricade_simplewall_piece01_destruct01	rigidmodels/buildings/textures	battle_building
siege_barricade_stairs_piece01_destruct01	rigidmodels/buildings/textures	battle_building
siege_barricade_stakes_piece01_destruct01	rigidmodels/buildings/textures	battle_building
siege_barricade_straight_piece01_destruct01	rigidmodels/buildings/textures	battle_building
siege_ladder_large_piece02_destruct01	rigidmodels/buildings/textures	battle_building
siege_ladders_piece01_destruct01	rigidmodels/buildings/textures	battle_building
siege_prop_flagpole	RigidModels/VerletItems/textures	battle_misc
slot_resource_furtrader	RigidModels/CampaignBuildings/Textures	campaign_building
slot_resource_mining_gems_lvl0	RigidModels/CampaignBuildings/Textures	campaign_building
slot_resource_mining_gold_lvl0	RigidModels/CampaignBuildings/Textures	campaign_building
slot_resource_mining_iron_lvl0	RigidModels/CampaignBuildings/Textures	campaign_building
slot_resource_mining_silver_lvl0	RigidModels/CampaignBuildings/Textures	campaign_building
slot_resource_ricepaddy	RigidModels/CampaignBuildings/Textures	campaign_building
slot_resource_timber	RigidModels/CampaignBuildings/Textures	campaign_building
slot_resource_vineyards	RigidModels/CampaignBuildings/Textures	campaign_building
small_arch_piece01_destruct01	rigidmodels/buildings/textures	battle_building
small_log_dry_piece01_destruct01	RigidModels\Buildings\AAA_TEXTURES	battle_building
small_log_piece01_destruct01	RigidModels\Buildings\AAA_TEXTURES	battle_building
small_paving_block_piece01_destruct01	rigidmodels/buildings/textures	battle_building
small_shade_piece01_destruct01	rigidmodels/buildings/textures	battle_building
small_wall_piece01_destruct01	rigidmodels/buildings/textures	battle_building
south_euro_townhall02_piece01_destruct01	RigidModels\Buildings\AAA_TEXTURES	battle_building
square_building01_piece01_destruct01	rigidmodels/buildings/textures	battle_building
square_paving_block_piece01_destruct01	rigidmodels/buildings/textures	battle_building
stadium_base_block_piece01_destruct01	rigidmodels/buildings/textures	battle_building
stadium_courtyard_piece01_destruct01	rigidmodels/buildings/textures	battle_building
stadium_foundations_piece01_destruct01	rigidmodels/buildings/textures	battle_building
stadium_gymnasium_piece01_destruct01	rigidmodels/buildings/textures	battle_building
stadium_piece01_destruct01	rigidmodels/buildings/textures	battle_building
stadium_shades_piece01_destruct01	rigidmodels/buildings/textures	battle_building
stairs_to_house_piece01_destruct01	rigidmodels/buildings/textures	battle_building
stool	RigidModels/props/textures	battle_misc
strat_selector	RigidModels\Flags\Textures	3Dindicators
street_barricades_door_1_piece01_destruct01	rigidmodels/buildings/textures	battle_building
street_barricades_door_2_piece01_destruct01	rigidmodels/buildings/textures	battle_building
street_barricades_door_3_piece01_destruct01	rigidmodels/buildings/textures	battle_building
street_barricades_high_1_piece01_destruct01	rigidmodels/buildings/textures	battle_building
street_barricades_high_2_piece01_destruct01	rigidmodels/buildings/textures	battle_building
street_barricades_low_1_piece01_destruct01	rigidmodels/buildings/textures	battle_building
street_barricades_low_2_piece01_destruct01	rigidmodels/buildings/textures	battle_building
street_barricades_low_3_piece01_destruct01	rigidmodels/buildings/textures	battle_building
street_barricades_rubble_1_piece01_destruct01	rigidmodels/buildings/textures	battle_building
street_barricades_rubble_2_piece01_destruct01	rigidmodels/buildings/textures	battle_building
street_barricades_streetborders_1_piece01_destruct01	rigidmodels/buildings/textures	battle_building
street_barricades_streetborders_2_piece01_destruct01	rigidmodels/buildings/textures	battle_building
suitable_deployable_item_chevaux_de_frise_marker	RigidModels\WarscapeFrame\ai_hints\Textures	3Dindicators
suitable_deployable_item_earthworks_marker	RigidModels\WarscapeFrame\ai_hints\Textures	3Dindicators
suitable_deployable_item_fougasse_marker	RigidModels\WarscapeFrame\ai_hints\Textures	3Dindicators
suitable_deployable_item_gabionade_marker	RigidModels\WarscapeFrame\ai_hints\Textures	3Dindicators
suitable_ground_bombardment_marker	RigidModels\WarscapeFrame\ai_hints\Textures	3Dindicators
t_paving_block_piece01_destruct01	rigidmodels/buildings/textures	battle_building
table_no_maps_piece01_destruct01	rigidmodels/buildings/textures	battle_building
tall_flatroof_building_piece01_destruct01	rigidmodels/buildings/textures	battle_building
tall_flatroof_corner_piece01_destruct01	rigidmodels/buildings/textures	battle_building
tall_roofed_house_piece01_destruct01	rigidmodels/buildings/textures	battle_building
temple_piece01_destruct01	rigidmodels/buildings/textures	battle_building
test_wall15_angled_joiner_min_spec_piece01_destruct01	rigidmodels/buildings/textures	battle_building
test_wall15_angled_joiner_piece01_destruct01	rigidmodels/buildings/textures	battle_building
test_wall15_buttress_to_snap_to_straight_piece01_destruct01	rigidmodels/buildings/textures	battle_building
test_wall15_destruct_bridging_column_piece01_destruct01	rigidmodels/buildings/textures	battle_building
test_wall15_destruct_bridging_crenel_piece01_destruct01	rigidmodels/buildings/textures	battle_building
test_wall15_destruct_level_1_piece01_destruct01	rigidmodels/buildings/textures	battle_building
test_wall15_destruct_level_2_piece01_destruct01	rigidmodels/buildings/textures	battle_building
test_wall15_destruct_level_3_piece01_destruct01	rigidmodels/buildings/textures	battle_building
test_wall15_destruct_level_4_piece01_destruct01	rigidmodels/buildings/textures	battle_building
test_wall15_external_angled_to_grid_joiner_min_spec_piece01_destruct01	rigidmodels/buildings/textures	battle_building
test_wall15_external_angled_to_grid_joiner_piece01_destruct01	rigidmodels/buildings/textures	battle_building
test_wall15_external_angled_to_grid_joiner_reinforced_piece01_destruct01	rigidmodels/buildings/textures	battle_building
test_wall15_external_corner_piece01_destruct01	rigidmodels/buildings/textures	battle_building
test_wall15_external_corner_reinforced_piece01_destruct01	rigidmodels/buildings/textures	battle_building
test_wall15_external_corner_with_rounded_bastion_b_piece01_destruct01	rigidmodels/buildings/textures	battle_building
test_wall15_external_corner_with_rounded_bastion_c_min_spec_piece01_destruct01	rigidmodels/buildings/textures	battle_building
test_wall15_external_corner_with_rounded_bastion_c_piece01_destruct01	rigidmodels/buildings/textures	battle_building
test_wall15_external_corner_with_rounded_bastion_d_piece01_destruct01	rigidmodels/buildings/textures	battle_building
test_wall15_external_corner_with_rounded_bastion_e_piece01_destruct01	rigidmodels/buildings/textures	battle_building
test_wall15_external_corner_with_rounded_bastion_piece01_destruct01	rigidmodels/buildings/textures	battle_building
test_wall15_external_grid_to_angled_joiner_min_spec_piece01_destruct01	rigidmodels/buildings/textures	battle_building
test_wall15_external_grid_to_angled_joiner_piece01_destruct01	rigidmodels/buildings/textures	battle_building
test_wall15_external_grid_to_angled_joiner_reinforced_piece01_destruct01	rigidmodels/buildings/textures	battle_building
test_wall15_gates_a_piece01_destruct01	rigidmodels/buildings/textures	battle_building
test_wall15_gateway_a_piece01_destruct01	rigidmodels/buildings/textures	battle_building
test_wall15_gateway_b_with_extension_piece01_destruct01	rigidmodels/buildings/textures	battle_building
test_wall15_gateway_c_with_extension_piece01_destruct01	rigidmodels/buildings/textures	battle_building
test_wall15_gateway_d_piece01_destruct01	rigidmodels/buildings/textures	battle_building
test_wall15_gateway_e_piece01_destruct01	rigidmodels/buildings/textures	battle_building
test_wall15_gateway_rounded_a_min_spec_piece01_destruct01	rigidmodels/buildings/textures	battle_building
test_wall15_gateway_rounded_a_piece01_destruct01	rigidmodels/buildings/textures	battle_building
test_wall15_gateway_rounded_b_angled_piece01_destruct01	rigidmodels/buildings/textures	battle_building
test_wall15_gateway_rounded_b_piece01_destruct01	rigidmodels/buildings/textures	battle_building
test_wall15_gateway_rounded_c_piece01_destruct01	rigidmodels/buildings/textures	battle_building
test_wall15_internal_angled_to_grid_joiner_min_spec_piece01_destruct01	rigidmodels/buildings/textures	battle_building
test_wall15_internal_angled_to_grid_joiner_piece01_destruct01	rigidmodels/buildings/textures	battle_building
test_wall15_internal_angled_to_grid_joiner_reinforced_piece01_destruct01	rigidmodels/buildings/textures	battle_building
test_wall15_internal_corner_piece01_destruct01	rigidmodels/buildings/textures	battle_building
test_wall15_internal_corner_reinforced_piece01_destruct01	rigidmodels/buildings/textures	battle_building
test_wall15_internal_grid_to_angled_joiner_min_spec_piece01_destruct01	rigidmodels/buildings/textures	battle_building
test_wall15_internal_grid_to_angled_joiner_piece01_destruct01	rigidmodels/buildings/textures	battle_building
test_wall15_internal_grid_to_angled_joiner_reinforced_piece01_destruct01	rigidmodels/buildings/textures	battle_building
test_wall15_straight_collapsed_40m_wide_piece01_destruct01	rigidmodels/buildings/textures	battle_building
test_wall15_straight_collapsed_60m_wide_piece01_destruct01	rigidmodels/buildings/textures	battle_building
test_wall15_straight_collapsed_piece01_destruct01	rigidmodels/buildings/textures	battle_building
test_wall15_straight_min_spec_piece01_destruct01	rigidmodels/buildings/textures	battle_building
test_wall15_straight_piece01_destruct01	rigidmodels/buildings/textures	battle_building
test_wall15_straight_stepped_down_10m_with_squared_bastion_a_piece01_destruct01	rigidmodels/buildings/textures	battle_building
test_wall15_straight_stepped_step_down_10m_piece01_destruct01	rigidmodels/buildings/textures	battle_building
test_wall15_straight_stepped_step_down_min_spec_piece01_destruct01	rigidmodels/buildings/textures	battle_building
test_wall15_straight_stepped_step_down_piece01_destruct01	rigidmodels/buildings/textures	battle_building
test_wall15_straight_stepped_step_up_10m_piece01_destruct01	rigidmodels/buildings/textures	battle_building
test_wall15_straight_stepped_step_up_min_spec_piece01_destruct01	rigidmodels/buildings/textures	battle_building
test_wall15_straight_stepped_step_up_piece01_destruct01	rigidmodels/buildings/textures	battle_building
test_wall15_straight_stepped_up_10m_with_squared_bastion_a_piece01_destruct01	rigidmodels/buildings/textures	battle_building
test_wall15_straight_stepped_up_piece01_destruct01	rigidmodels/buildings/textures	battle_building
test_wall15_straight_with_arches_a_piece01_destruct01	rigidmodels/buildings/textures	battle_building
test_wall15_straight_with_arches_b_piece01_destruct01	rigidmodels/buildings/textures	battle_building
test_wall15_straight_with_arches_c_piece01_destruct01	rigidmodels/buildings/textures	battle_building
test_wall15_straight_with_arches_d_piece01_destruct01	rigidmodels/buildings/textures	battle_building
test_wall15_straight_with_arches_d_piece01_destruct02	rigidmodels/buildings/textures	battle_building
test_wall15_straight_with_arches_d_piece01_destruct03	rigidmodels/buildings/textures	battle_building
test_wall15_straight_with_doors_a_piece01_destruct01	rigidmodels/buildings/textures	battle_building
test_wall15_straight_with_doors_b_piece01_destruct01	rigidmodels/buildings/textures	battle_building
test_wall15_straight_with_extension_min_spec_piece01_destruct01	rigidmodels/buildings/textures	battle_building
test_wall15_straight_with_extension_piece01_destruct01	rigidmodels/buildings/textures	battle_building
test_wall15_straight_with_ramp_and_1_arch_piece01_destruct01	rigidmodels/buildings/textures	battle_building
test_wall15_straight_with_ramp_and_4_arches_piece01_destruct01	rigidmodels/buildings/textures	battle_building
test_wall15_straight_with_ramp_piece01_destruct01	rigidmodels/buildings/textures	battle_building
test_wall15_straight_with_ramp_stepped_down_piece01_destruct01	rigidmodels/buildings/textures	battle_building
test_wall15_straight_with_solid_rounded_bastion_min_spec_piece01_destruct01	rigidmodels/buildings/textures	battle_building
test_wall15_straight_with_solid_rounded_bastion_piece01_destruct01	rigidmodels/buildings/textures	battle_building
test_wall15_straight_with_solid_squared_bastion_and_onager_piece01_destruct01	rigidmodels/buildings/textures	battle_building
test_wall15_straight_with_solid_squared_bastion_destroyed_piece01_destruct01	rigidmodels/buildings/textures	battle_building
test_wall15_straight_with_solid_squared_bastion_piece01_destruct01	rigidmodels/buildings/textures	battle_building
test_wall15_straight_with_wooden_ramp_double_winder_piece01_destruct01	rigidmodels/buildings/textures	battle_building
test_wall15_terrace_cordonata_10m_high_piece01_destruct01	rigidmodels/buildings/textures	battle_building
test_wall15_terrace_cordonata_piece01_destruct01	rigidmodels/buildings/textures	battle_building
test_wall15_terrace_edge_10m_wide_piece01_destruct01	rigidmodels/buildings/textures	battle_building
test_wall15_terrace_edge_angled_joiner_piece01_destruct01	rigidmodels/buildings/textures	battle_building
test_wall15_terrace_edge_endcap_left_piece01_destruct01	rigidmodels/buildings/textures	battle_building
test_wall15_terrace_edge_endcap_right_piece01_destruct01	rigidmodels/buildings/textures	battle_building
test_wall15_terrace_edge_external_angled_to_grid_joiner_piece01_destruct01	rigidmodels/buildings/textures	battle_building
test_wall15_terrace_edge_external_corner_piece01_destruct01	rigidmodels/buildings/textures	battle_building
test_wall15_terrace_edge_external_grid_to_angled_joiner_piece01_destruct01	rigidmodels/buildings/textures	battle_building
test_wall15_terrace_edge_internal_angled_to_grid_joiner_piece01_destruct01	rigidmodels/buildings/textures	battle_building
test_wall15_terrace_edge_internal_grid_to_angled_joiner_piece01_destruct01	rigidmodels/buildings/textures	battle_building
test_wall15_terrace_edge_piece01_destruct01	rigidmodels/buildings/textures	battle_building
test_wall15_terrace_internal_corner_piece01_destruct01	rigidmodels/buildings/textures	battle_building
test_wall15_terrace_steps_inset_10m_high_piece01_destruct01	rigidmodels/buildings/textures	battle_building
test_wall15_terrace_steps_inset_15m_high_piece01_destruct01	rigidmodels/buildings/textures	battle_building
test_wall15_terrace_steps_inset_5m_high_piece01_destruct01	rigidmodels/buildings/textures	battle_building
test_wall15_terrace_steps_inset_narrow_10m_high_piece01_destruct01	rigidmodels/buildings/textures	battle_building
test_wall15_terrace_steps_inset_no_wings_10m_high_piece01_destruct01	rigidmodels/buildings/textures	battle_building
test_wall15_terrace_steps_narrow_piece01_destruct01	rigidmodels/buildings/textures	battle_building
test_wall15_terrace_steps_piece01_destruct01	rigidmodels/buildings/textures	battle_building
test_wall15_tower_a_corner_min_spec_piece01_destruct01	rigidmodels/buildings/textures	battle_building
test_wall15_tower_a_corner_piece01_destruct01	rigidmodels/buildings/textures	battle_building
test_wall15_tower_a_corner_with_extension_piece01_destruct01	rigidmodels/buildings/textures	battle_building
test_wall15_tower_b_corner_with_extension_piece01_destruct01	rigidmodels/buildings/textures	battle_building
test_wall15_tower_c_straight_with_extension_piece01_destruct01	rigidmodels/buildings/textures	battle_building
test_wall15_tower_d_end_left_piece01_destruct01	rigidmodels/buildings/textures	battle_building
test_wall15_tower_d_end_right_piece01_destruct01	rigidmodels/buildings/textures	battle_building
test_wall15_tower_d_straight_piece01_destruct01	rigidmodels/buildings/textures	battle_building
test_wall15_tower_step_down_with_extension_piece01_destruct01	rigidmodels/buildings/textures	battle_building
test_wall15_tower_step_up_with_extension_piece01_destruct01	rigidmodels/buildings/textures	battle_building
test_wall15_trapdoor_attachment_min_spec_piece01_destruct01	rigidmodels/buildings/textures	battle_building
test_wall15_trapdoor_attachment_piece01_destruct01	rigidmodels/buildings/textures	battle_building
tile_roofed_houses_piece01_destruct01	rigidmodels/buildings/textures	battle_building
tortoise_piece01_destruct01	rigidmodels/buildings/textures	battle_building
tower_building01_piece01_destruct01	rigidmodels/buildings/textures	battle_building
town_cluster_marker	RigidModels\WarscapeFrame\ai_hints\Textures	3Dindicators
trash	RigidModels\Buildings\AAA_TEXTURES	battle_building
trash_d02	RigidModels\Buildings\AAA_TEXTURES	battle_building
tree_plinth_piece01_destruct01	rigidmodels/buildings/textures	battle_building
tree_stump_and_log_dry_piece01_destruct01	RigidModels\Buildings\AAA_TEXTURES	battle_building
tree_stump_and_log_piece01_destruct01	RigidModels\Buildings\AAA_TEXTURES	battle_building
tree_stump_dry_piece01_destruct01	RigidModels\Buildings\AAA_TEXTURES	battle_building
tree_stump_piece01_destruct01	RigidModels\Buildings\AAA_TEXTURES	battle_building
trees	RigidModels/Vegetation/CampaignTrees/Textures	campaign_trees
ushape_building_piece01_destruct01	rigidmodels/buildings/textures	battle_building
villa_piece01_destruct01	rigidmodels/buildings/textures	battle_building
villa_tower_roof_piece01_destruct01	rigidmodels/buildings/textures	battle_building
wall_end_piece01_destruct01	RigidModels\BattleFieldProps\Textures	battle_misc
wood_pile_a_large_piece01_destruct01	rigidmodels/buildings/textures	battle_building
wood_pile_a_large_piece01_destruct02	rigidmodels/buildings/textures	battle_building
wood_pile_a_piece01_destruct01	rigidmodels/buildings/textures	battle_building
wood_pile_a_piece01_destruct02	rigidmodels/buildings/textures	battle_building
wood_pile_b_large_piece01_destruct01	rigidmodels/buildings/textures	battle_building
wood_pile_b_large_piece01_destruct02	rigidmodels/buildings/textures	battle_building
wood_pile_b_piece01_destruct01	rigidmodels/buildings/textures	battle_building
wood_pile_b_piece01_destruct02	rigidmodels/buildings/textures	battle_building
wood_stack_large_piece01_destruct01	rigidmodels/buildings/textures	battle_building
wood_stack_large_piece01_destruct02	rigidmodels/buildings/textures	battle_building
wood_stack_piece01_destruct01	rigidmodels/buildings/textures	battle_building
wood_stack_piece01_destruct02	rigidmodels/buildings/textures	battle_building
woodenfence_1_piece01_destruct01	RigidModels\BattleFieldProps\Textures	battle_misc
woodenfence_2_piece01_destruct01	RigidModels\BattleFieldProps\Textures	battle_misc
woodenfence_4_piece01_destruct01	RigidModels\BattleFieldProps\Textures	battle_misc
woodenfence_8_piece01_destruct01	RigidModels\BattleFieldProps\Textures	battle_misc
woodenfence_piece01_destruct01	RigidModels\BattleFieldProps\Textures	battle_misc
woodenfenceend_piece01_destruct01	RigidModels\BattleFieldProps\Textures	battle_misc
woodengate_piece01_destruct01	RigidModels\BattleFieldProps\Textures	battle_misc
woodenstile_piece01_destruct01	RigidModels\BattleFieldProps\Textures	battle_misc
