event	culture	movie	id
#movie_event_strings_tables;0;db/movie_event_strings_tables/movie_event_strings			
civil_war_begin_barb	rom_Barbarian	RomeII/civil_war_begin_barb.bik	700
civil_war_begin_east	rom_Eastern	RomeII/civil_war_begin_east_egypt.bik	699
civil_war_begin_hellen_egypt	rom_Hellenistic	RomeII/civil_war_begin_east_egypt.bik	764
civil_war_begin_hellen	rom_Hellenistic	RomeII/civil_war_begin_rome_hellen.bik	696
civil_war_begin_rome	rom_Roman	RomeII/civil_war_begin_rome_hellen.bik	397
civil_war_ends_barb	rom_Barbarian	RomeII/civil_war_end_barb.bik	735
civil_war_ends_east	rom_Eastern	RomeII/civil_war_end_east.bik	726
civil_war_ends_hellen_egypt	rom_Hellenistic	RomeII/civil_war_end_egypt.bik	718
civil_war_ends_hellen	rom_Hellenistic	RomeII/civil_war_end_hellen.bik	768
civil_war_ends_rome	rom_Roman	RomeII/civil_war_end_hellen.bik	709
faction_win_3c_alani	rom_Barbarian	RomeII/faction_win_ed_alani.bik	1051
faction_win_3c_armenia	rom_Eastern	RomeII/faction_win_ed_armenia.bik	1061
faction_win_3c_gallicemp	rom_Roman	RomeII/faction_win_ed_gallic_rome.bik	1027
faction_win_3c_gothi	rom_Barbarian	RomeII/faction_win_ed_gothi.bik	1053
faction_win_3c_palmyra	rom_Roman	RomeII/faction_win_ed_palmyra.bik	1033
faction_win_3c_rome	rom_Roman	RomeII/faction_win_ed_rome.bik	1017
faction_win_3c_sassanid	rom_Eastern	RomeII/faction_win_ed_sassinid.bik	1041
faction_win_barb	rom_Barbarian	RomeII/faction_win_barb.bik	737
faction_win_east	rom_Eastern	RomeII/faction_win_east.bik	745
faction_win_emp_antony	rom_Roman	RomeII/imp_aug_win_ant.bik	1009
faction_win_emp_lepidus	rom_Roman	RomeII/imp_aug_win_lep.bik	1012
faction_win_emp_octavian	rom_Roman	RomeII/imp_aug_win_oct.bik	1005
faction_win_emp_pompey	rom_Roman	RomeII/imp_aug_win_pom.bik	1013
faction_win_hellen_egypt	rom_Hellenistic	RomeII/faction_win_egypt.bik	750
faction_win_hellen	rom_Hellenistic	RomeII/faction_win_hellen.bik	751
faction_win_inv_insubres	rom_Barbarian	RomeII/faction_win_inv_gallic.bik	1147
faction_win_inv_iolei	rom_Barbarian	RomeII/faction_win_inv_iolei.bik	1170
faction_win_inv_rome	rom_Roman	RomeII/faction_win_inv_rome.bik	1127
faction_win_inv_samnites	rom_Roman	RomeII/faction_win_inv_samnites.bik	1155
faction_win_inv_senones	rom_Barbarian	RomeII/faction_win_inv_gallic.bik	1141
faction_win_inv_syracuse	rom_Hellenistic	RomeII/faction_win_inv_greek.bik	1180
faction_win_inv_taranto	rom_Hellenistic	RomeII/faction_win_inv_greek.bik	1160
faction_win_inv_tarchuna	rom_Roman	RomeII/faction_win_inv_tarchuna.bik	1132
faction_win_inv_veneti	rom_Roman	RomeII/faction_win_inv_gallic.bik	1149
faction_win_pun_carthage	rom_Hellenistic	RomeII/hangates_carthage_win.bik	995
faction_win_pun_rome	rom_Roman	RomeII/hangates_rome_win.bik	990
faction_win_rom_kush	rom_Eastern	RomeII/faction_win_dk_kush.bik	1097
faction_win_rom_masaesyli	rom_Eastern	RomeII/faction_win_dk_nab_sab_mas.bik	1114
faction_win_rom_nabatea	rom_Eastern	RomeII/faction_win_dk_nab_sab_mas.bik	1102
faction_win_rom_saba	rom_Eastern	RomeII/faction_win_dk_nab_sab_mas.bik	1105
faction_win_rome	rom_Roman	RomeII/faction_win_rome.bik	760
gaul_gallic_uprising_barb	rom_Barbarian	RomeII/caesar_in_gaul_gallic_uprising.bik	981
gaul_gallic_uprising_rome	rom_Roman	RomeII/caesar_in_gaul_gallic_uprising.bik	964
gaul_roman_intervention_barb	rom_Barbarian	RomeII/caesar_in_gaul_roman_intervention.bik	928
gaul_roman_intervention_east	rom_Eastern	RomeII/caesar_in_gaul_roman_intervention.bik	942
gaul_roman_intervention_hellen	rom_Hellenistic	RomeII/caesar_in_gaul_roman_intervention.bik	947
general_death_barb_fem	rom_Barbarian	RomeII/general_death_barb_fem.bik	1068
general_death_barb	rom_Barbarian	RomeII/general_death_barb.bik	778
general_death_east_fem	rom_Eastern	RomeII/general_death_east_fem.bik	1077
general_death_east	rom_Eastern	RomeII/general_death_east.bik	791
general_death_hellen_egypt_fem	rom_Hellenistic	RomeII/general_death_egypt_fem.bik	1084
general_death_hellen_egypt	rom_Hellenistic	RomeII/general_death_egypt.bik	800
general_death_hellen_fem	rom_Hellenistic	RomeII/general_death_hellen_fem.bik	1079
general_death_hellen	rom_Hellenistic	RomeII/general_death_hellen.bik	792
general_death_rom_kush_fem	rom_Eastern	RomeII/general_death_africa_fem.bik	1119
general_death_rom_kush	rom_Eastern	RomeII/general_death_east.bik	1124
general_death_rome_fem	rom_Roman	RomeII/general_death_rome_fem.bik	1088
general_death_rome	rom_Roman	RomeII/general_death_rome.bik	787
rome_captured_barb	rom_Barbarian	RomeII/rome_captured_barb.bik	807
rome_captured_east	rom_Eastern	RomeII/rome_captured_east.bik	811
rome_captured_hellen_egypt	rom_Hellenistic	RomeII/rome_captured_egypt.bik	821
rome_captured_hellen	rom_Hellenistic	RomeII/rome_captured_hellen.bik	826
rome_captured_rome_attacker	rom_Roman	RomeII/rome_captured_rome_attacker.bik	835
rome_captured_rome_defender	rom_Roman	RomeII/rome_captured_rome_defender.bik	843
rome_triumph_1	rom_Roman	RomeII/triumph_1.bik	904
rome_triumph_2	rom_Roman	RomeII/triumph_2.bik	913
rome_triumph_3	rom_Roman	RomeII/triumph_3.bik	922
slave_uprising_begin_barb	rom_Barbarian	RomeII/slave_uprising_begin_barb.bik	848
slave_uprising_begin_east	rom_Eastern	RomeII/slave_uprising_begin_east_egypt.bik	853
slave_uprising_begin_hellen_egypt	rom_Hellenistic	RomeII/slave_uprising_begin_east_egypt.bik	855
slave_uprising_begin_hellen	rom_Hellenistic	RomeII/slave_uprising_begin_rome_hellen.bik	861
slave_uprising_begin_rome	rom_Roman	RomeII/slave_uprising_begin_rome_hellen.bik	866
slave_uprising_end_barb	rom_Barbarian	RomeII/slave_uprising_end_barb.bik	868
slave_uprising_end_east	rom_Eastern	RomeII/slave_uprising_end_east_egypt.bik	876
slave_uprising_end_hellen_egypt	rom_Hellenistic	RomeII/slave_uprising_end_east_egypt.bik	885
slave_uprising_end_hellen	rom_Hellenistic	RomeII/slave_uprising_end_rome_hellen.bik	888
slave_uprising_end_rome	rom_Roman	RomeII/slave_uprising_end_rome_hellen.bik	895
