key	text	tooltip
#Loc;1;text/db/land_units.loc		
land_units_onscreen_name_inv_carthaginian_spearmen	Native Carthaginian Spearmen	true
land_units_onscreen_name_inv_umbrian_hillmen	Native Umbrian Hillmen	true
land_units_onscreen_name_Eas_Horse_Archers	Horse Archers	true
land_units_onscreen_name_Gre_Massilian_Cav	Massilian Cavalry	true
land_units_onscreen_name_inv_brutii_slingers	Native Bruttii Slingers	true
land_units_onscreen_name_Bac_Horse_Archers	Bactrian Horse Archers	true
land_units_onscreen_name_Ste_Horse_Archers	Steppe Horse Archers	true
land_units_onscreen_name_3c_Aux_Briton_Slingers	Auxiliary Briton Slingers	true
land_units_onscreen_name_3c_Pal_Armoured_Swordsmen	Armoured Swordsmen	true
land_units_onscreen_name_3c_Sas_Immortal_Infantry_Guard	Immortal Infantry Guard	true
land_units_onscreen_name_3c_Num_Numidian_Swordsmen	Numidian Swordsmen	true
land_units_onscreen_name_Dac_Ballista	Dacian Ballista	true
land_units_onscreen_name_Mer_Cel_Axe_Warriors	Mercenary Axe Warriors	true
land_units_onscreen_name_Bac_Peltasts	Bactrian Peltasts	true
land_units_onscreen_name_3c_Sas_Savaran_Cavalry	Savaran Cavalry	true
land_units_onscreen_name_3c_Mer_Persian_Cavalry	Mercenary Persian Cavalry	true
land_units_onscreen_name_3c_Per_Persian_Cavalry	Persian Cavalry	true
land_units_onscreen_name_3c_Ala_Taifali_Cavalry	Taifali Cavalry	true
land_units_onscreen_name_Rom_Ballista_Bastion	Roman Bastion Ballista	true
land_units_onscreen_name_inv_rom_roman_light_hoplites	Roman Light Hoplites	true
land_units_onscreen_name_Mer_Num_Javelinmen	Mercenary Numidian Javelinmen	true
land_units_onscreen_name_Rom_Velites	Velites	true
land_units_onscreen_name_Dac_Skirm	Dacian Skirmishers	true
land_units_onscreen_name_Cel_Skirm	Celtic Skirmishers	true
land_units_onscreen_name_inv_ita_veteran_swordsmen	Italian Veteran Swordsmen	true
land_units_onscreen_name_Bri_Skirm	Briton Skirmishers	true
land_units_onscreen_name_Ibe_Sword	Iberian Swordsmen	true
land_units_onscreen_name_Ita_Sword	Italian Swordsmen	true
land_units_onscreen_name_Mer_Bri_Spear_Band	Mercenary Spear Band	true
land_units_onscreen_name_Ibe_Skirm	Iberian Skirmishers	true
land_units_onscreen_name_Aet_Sword	Swordsmen	true
land_units_onscreen_name_Thr_Skirm	Thracian Skirmishers	true
land_units_onscreen_name_3c_Arm_Azat_Guard	Azat Guard	true
land_units_onscreen_name_inv_umbrian_spearmen	Native Umbrian Spearmen	true
land_units_onscreen_name_3c_Aux_Celtic_Spearmen	Auxiliary Celtic Spearmen	true
land_units_onscreen_name_Eas_Persian_Hoplites	Persian Hoplites	true
land_units_onscreen_name_inv_sen_young_swords	Young Swords	true
land_units_onscreen_name_Ara_Slingers	Slingers	true
land_units_onscreen_name_3c_Gal_Equites_Promoti	Equites Promoti	true
land_units_onscreen_name_3c_Gal_Gallic_Imperial_Guard	Gallic Imperial Guard	true
land_units_onscreen_name_Cel_Ballista_Bastion	Celtic Bastion Ballista	true
land_units_onscreen_name_Pel_Thr_Cav	Thraike Cavalry	true
land_units_onscreen_name_Mer_Egy_Inf	Mercenary Egyptian Infantry	true
land_units_onscreen_name_Mer_Thr_Cav	Mercenary Thracian Cavalry	true
land_units_onscreen_name_3c_Ste_Steppe_War_Dogs	Steppe War Dogs	true
land_units_onscreen_name_Ill_Hoplites	Illyrian Hoplites	true
land_units_onscreen_name_Pel_Hoplites	Hoplites	true
land_units_onscreen_name_Ibe_Scutarii	Scutarii	true
land_units_onscreen_name_Bac_Hillmen	Bactrian Hillmen	true
land_units_onscreen_name_Car_Citizen_Militia	Citizen Militia	true
land_units_onscreen_name_inv_etr_city_guard	Etruscan City Guard	true
land_units_onscreen_name_Eas_Hillmen	Hillmen	true
land_units_onscreen_name_Car_Late_Hoplites	Late Carthaginian Hoplites	true
land_units_onscreen_name_Eas_Elite_Persian_Archers	Elite Persian Archers	true
land_units_onscreen_name_Eas_Scorpion_Pot_Ballista	Scorpion Pot Ballista	true
land_units_onscreen_name_inv_rom_veteran_centuriae	Veteran Centuriae	true
land_units_onscreen_name_Rom_War_Dogs	War Dogs	true
land_units_onscreen_name_3c_Aux_Germanic_Swordsmen	Auxiliary Germanic Swordsmen	true
land_units_onscreen_name_inv_car_carthaginian_javelin	Carthaginian Javelinmen	true
land_units_onscreen_name_3c_Aux_Persian_Archers	Auxiliary Persian Archers	true
land_units_onscreen_name_inv_etr_skirmishers	Etruscan Skirmishers	true
land_units_onscreen_name_Aux_Gre_Citizen_Cav	Auxiliary Citizen Cavalry	true
land_units_onscreen_name_Gre_Picked_Hoplites	Picked Hoplites	true
land_units_onscreen_name_inv_sabine_warriors	Native Sabine Warriors	true
land_units_onscreen_name_Gre_Rhodian_Slingers	Rhodian Slingers	true
land_units_onscreen_name_Gre_Spartan_Hoplites	Spartan Hoplites	true
land_units_onscreen_name_3c_Rom_Cheiroballistra	Roman Scorpion	true
land_units_onscreen_name_Bri_Ballista_Bastion	Briton Bastion Ballista	true
land_units_onscreen_name_Bri_Cheiroballistra	Briton Scorpion	true
land_units_onscreen_name_Gre_Cheiroballistra	Greek Scorpion	true
land_units_onscreen_name_Rom_General	General & Bodyguard	true
land_units_onscreen_name_Thr_Tribal_Garrison	Tribal Garrison	true
land_units_onscreen_name_3c_Ger_Germanic_Swordsmen	Germanic Swordsmen	true
land_units_onscreen_name_3c_Pal_Palmyrene_Cataphracts	Palmyrene Cataphracts 	true
land_units_onscreen_name_Gre_Slingers	Slingers	true
land_units_onscreen_name_Ibe_Slingers	Iberian Slingers	true
land_units_onscreen_name_Ste_Armoured_Lancers	Steppe Armoured Lancers	true
land_units_onscreen_name_Rom_Evocati_Cohort	Evocati Cohort	true
land_units_onscreen_name_Aux_Eas_Javelinmen	Auxiliary Eastern Javelinmen	true
land_units_onscreen_name_Mer_Ill_Cav	Mercenary Illyrian Cavalry	true
land_units_onscreen_name_Ill_Marines	Illyrian Marines	true
land_units_onscreen_name_3c_Eas_Eastern_Axe_Warriors	Eastern Axe Warriors	true
land_units_onscreen_name_Eas_Parthian_Foot_Archers	Parthian Foot Archers	true
land_units_onscreen_name_inv_volsci_warriors	Native Volsci Warriors	true
land_units_onscreen_name_inv_volsci_spearmen	Native Volsci Spearmen	true
land_units_onscreen_name_Gre_Militia_Hoplites	Militia Hoplites	true
land_units_onscreen_name_3c_Mer_Celtic_Horsemen	Mercenary Celtic Horsemen	true
land_units_onscreen_name_3c_Cel_Celtic_Horsemen	Celtic Horsemen	true
land_units_onscreen_name_3c_Aux_Thracian_Horse_Skirmishers	Auxiliary Thracian Horse Skirmishers	true
land_units_onscreen_name_Gre_Ballista	Greek Ballista	true
land_units_onscreen_name_Ibe_Ballista	Iberian Ballista	true
land_units_onscreen_name_Ste_Ballista	Steppe Ballista	true
land_units_onscreen_name_Eas_Scorpion_Bastion	Eastern Bastion Scorpion	true
land_units_onscreen_name_Gre_Peltasts	Peltasts	true
land_units_onscreen_name_3c_Ara_Arabian_Javelinmen	Arabian Javelinmen	true
land_units_onscreen_name_3c_Aux_Alae_Cavalry	Alae Cavalry	true
land_units_onscreen_name_Gre_Beehive_Onager	Greek Beehive Onager	true
land_units_onscreen_name_Pel_Hillmen	Hillmen	true
land_units_onscreen_name_Cel_Veteran_Spears	Veteran Spears	true
land_units_onscreen_name_Rom_Rorarii	Rorarii	true
land_units_onscreen_name_Pel_Javelin_Marines	Javelin Marines	true
land_units_onscreen_name_Bri_Veteran_Riders	Veteran Riders	true
land_units_onscreen_name_Pel_Spartan_Youths	Spartan Youths	true
land_units_onscreen_name_inv_local_gallic_horsemen	Native Gallic Horsemen	true
land_units_onscreen_name_Ger_Horse_Runners	Horse Runners	true
land_units_onscreen_name_Rom_Onager_Prologue	Ballista	true
land_units_onscreen_name_3c_Sax_Saxon_Raiders	Saxoni Raiders	true
land_units_onscreen_name_Afr_Scorpion_Bastion	African Bastion Scorpion	true
land_units_onscreen_name_Bri_Chariots	Chariots	true
land_units_onscreen_name_Car_Scorpion_Bastion	Carthaginian Bastion Scorpion	true
land_units_onscreen_name_Ger_Scorpion_Bastion	German Bastion Scorpion	true
land_units_onscreen_name_3c_Aux_Archers	Auxiliary Archers	true
land_units_onscreen_name_3c_Gal_Equites	Equites	true
land_units_onscreen_name_Afr_Archers	Archers	true
land_units_onscreen_name_Mer_Ibe_Cav	Mercenary Iberian Cavalry	true
land_units_onscreen_name_Bri_Druidic_Nobles	Druidic Nobles	true
land_units_onscreen_name_Aux_Ara_Cav	Auxiliary Arabian Cavalry	true
land_units_onscreen_name_Pel_Persian_Archer_Marines	Persian Archer Marines	true
land_units_onscreen_name_3c_Goth_Gothic_Archers_comm	Gothic Archers Bodyguard	true
land_units_onscreen_name_Pel_Light_Cavalry	Light Cavalry	true
land_units_onscreen_name_inv_ven_italian_swordsmen	Italian Swordsmen	true
land_units_onscreen_name_3c_Pal_Palmyrene_Skirmishers	Palmyrene Skirmishers	true
land_units_onscreen_name_3c_Rom_Horse_Archers	Horse Archers	true
land_units_onscreen_name_3c_Aux_Sabean_Spearmen	Auxiliary Sabaean Spearmen	true
land_units_onscreen_name_Eas_Scorpion	Eastern Scorpion (Fixed)	true
land_units_onscreen_name_Gre_Ballista_Bastion	Greek Bastion Ballista	true
land_units_onscreen_name_Ibe_Ballista_Bastion	Iberian Bastion Ballista	true
land_units_onscreen_name_Ste_Ballista_Bastion	Steppe Bastion Ballista	true
land_units_onscreen_name_3c_Mer_Eastern_Pikemen	Mercenary Eastern Pikemen	true
land_units_onscreen_name_Ste_Saka_Cataphracts	Saka Cataphracts	true
land_units_onscreen_name_Egy_Archers	Egyptian Archers	true
land_units_onscreen_name_Ste_Lancers	Steppe Lancers	true
land_units_onscreen_name_Rom_Legionary_Cav	Legionary Cavalry	true
land_units_onscreen_name_Gre_Picked_Peltasts	Picked Peltasts	true
land_units_onscreen_name_Thr_Warriors	Thracian Warriors	true
land_units_onscreen_name_Bri_Slingers	Briton Slingers	true
land_units_onscreen_name_Afr_Scorpion	African Scorpion (Fixed)	true
land_units_onscreen_name_Car_Scorpion	Carthaginian Scorpion (Fixed)	true
land_units_onscreen_name_Ger_Scorpion	German Scorpion (Fixed)	true
land_units_onscreen_name_3c_Rom_Equites	Equites	true
land_units_onscreen_name_Cel_Galatian_Raiders	Galatian Raiders	true
land_units_onscreen_name_Rom_Vet_Legionaries	Veteran Legionaries	true
land_units_onscreen_name_Mer_Eas_Javelinmen	Mercenary Eastern Javelinmen	true
land_units_onscreen_name_Eas_Cappadocian_Cav	Cappadocian Cavalry	true
land_units_onscreen_name_inv_car_sacred_band	Sacred Band	true
land_units_onscreen_name_3c_Mer_Thracian_Horse_Skirmishers	Mercenary Thracian Horse Skirmishers	true
land_units_onscreen_name_Bri_Ballista	Briton Ballista	true
land_units_onscreen_name_3c_Eas_Cheiroballistra	Eastern Scorpion	true
land_units_onscreen_name_Aux_Cel_Axe_Warriors	Auxiliary Axe Warriors	true
land_units_onscreen_name_3c_Eas_Eastern_Javelinmen	Eastern Javelinmen	true
land_units_onscreen_name_Dac_Falxmen	Falxmen	true
land_units_onscreen_name_Car_General	General's Bodyguard	true
land_units_onscreen_name_Ibe_Celtiberian_Cav	Celtiberian Cavalry	true
land_units_onscreen_name_Pel_Archers	Archers	true
land_units_onscreen_name_3c_Goth_Elite_Gothic_Archers	Elite Gothic Archers	true
land_units_onscreen_name_3c_Eas_Scorpion_Pot_Ballista	Scorpion Pot Ballista	true
land_units_onscreen_name_3c_Marc_Wodanaz_Spears	Wodanaz Spears	true
land_units_onscreen_name_3c_Aux_Hillmen	Auxiliary Hillmen	true
land_units_onscreen_name_Gre_Hoplites	Hoplites	true
land_units_onscreen_name_Ger_Longbow_Hunters	Longbow Hunters	true
land_units_onscreen_name_Mer_Afr_Cav	Mercenary Sabean Cavalry	true
land_units_onscreen_name_Ste_Noble_Lancers	Steppe Noble Lancers	true
land_units_onscreen_name_3c_Ste_Steppe_Slingers	Steppe Slingers	true
land_units_onscreen_name_3c_Rom_Praetorian_Cavalry_comm	Praetorian Cavalry Bodyguard	true
land_units_onscreen_name_Cel_Slingers	Celtic Slingers	true
land_units_onscreen_name_Pel_Slingers	Slingers	true
land_units_onscreen_name_3c_Eas_Eastern_Pikemen	Eastern Pikemen	true
land_units_onscreen_name_inv_sam_italian_slingers_ver_sacrum	Ver Sacrum Slingers	true
land_units_onscreen_name_Aux_Num_Javelinmen	Auxiliary Numidian Javelinmen	true
land_units_onscreen_name_Rom_Vigiles	Vigiles	true
land_units_onscreen_name_Aux_Afr_Spr	Auxiliary Sabaean Spearmen	true
land_units_onscreen_name_Gre_Companion_Cav	Companion Cavalry	true
land_units_onscreen_name_inv_ligurian_axe_warriors	Native Ligurian Axe Warriors	true
land_units_onscreen_name_Afr_Tribal_Slingers	Tribal Slingers	true
land_units_onscreen_name_Aux_Bri_Spear_Band	Auxiliary Spear Band	true
land_units_onscreen_name_Gre_Thureos_Hoplites	Thureos Hoplites	true
land_units_onscreen_name_Pel_Spartan_Hoplites	Spartan Hoplites	true
land_units_onscreen_name_inv_sam_linen_legion	Linen Legion	true
land_units_onscreen_name_3c_Afr_Cheiroballistra	African Scorpion	true
land_units_onscreen_name_Mer_Gre_Vet_Hoplites	Mercenary Veteran Hoplites	true
land_units_onscreen_name_3c_Gal_Taifali_Cavalry	Taifali Cavalry	true
land_units_onscreen_name_inv_car_mob	Mob	true
land_units_onscreen_name_dk_num_armoured_numidian_spearmen	Armoured Numidian Spearmen	true
land_units_onscreen_name_3c_Eas_Ballista_Shp	Eastern Ballista (Ship)	true
land_units_onscreen_name_Ibe_Lusitani_Spear	Lusitani Spearmen	true
land_units_onscreen_name_Cel_Raiding_Horsemen	Raiding Horsemen	true
land_units_onscreen_name_3c_Sax_Duguth_Spearmen	Duguth Spearmen	true
land_units_onscreen_name_Rom_Ballista	Roman Ballista	true
land_units_onscreen_name_3c_Ger_Cheiroballistra	German Scorpion	true
land_units_onscreen_name_3c_Aux_Eastern_Javelinmen	Auxiliary Eastern Javelinmen	true
land_units_onscreen_name_inv_etr_axe_infantry	Etruscan Axe Infantry	true
land_units_onscreen_name_Dac_Ballista_Bastion	Dacian Bastion Ballista	true
land_units_onscreen_name_Pel_Baktrian_Cavalry	Baktrian Cavalry	true
land_units_onscreen_name_Aux_Num_Cav	Auxiliary Numidian Cavalry	true
land_units_onscreen_name_Eas_Archers	Eastern Archers	true
land_units_onscreen_name_Pel_Persian_Archers	Persian Archers	true
land_units_onscreen_name_Bri_Farmers	Farmers	true
land_units_onscreen_name_Pel_Marines	Marines	true
land_units_onscreen_name_Mer_Per_Cav	Mercenary Persian Cavalry	true
land_units_onscreen_name_Mer_Ger_Spearwomen	Mercenary Spearwomen	true
land_units_onscreen_name_Pel_Militia_Hoplites	Militia Hoplites	true
land_units_onscreen_name_3c_Marc_Horse_Hewers	Horse Hewers	true
land_units_onscreen_name_dk_num_desert_cohort	Desert Cohort	true
land_units_onscreen_name_3c_Gal_Gallic_Imperial_Guard_comm	Gallic Imperial Bodyguard	true
land_units_onscreen_name_Cel_Ballista	Celtic Ballista	true
land_units_onscreen_name_Mer_Pel_Thr_Peltasts	Mercenary Thraike Peltasts	true
land_units_onscreen_name_inv_mercenary_veneti_raiders	Mercenary Veneti Raiders	true
land_units_onscreen_name_3c_Gal_Veteran_Gallic_Legionaries	Veteran Gallic Legionaries	true
land_units_onscreen_name_3c_Rom_Equites_Promoti	Equites Promoti	true
land_units_onscreen_name_3c_Gal_Heavy_Gallic_Spearmen	Heavy Gallic Spearmen	true
land_units_onscreen_name_Gre_Spartan_Youths	Spartan Youths	true
land_units_onscreen_name_3c_Rom_Ballista_Shp	Roman Ballista (Ship)	true
land_units_onscreen_name_3c_Goth_Gothic_Axe_Warriors	Gothic Axe Warriors	true
land_units_onscreen_name_dk_nab_nabatean_swordsmen	Nabataean Swordsmen	true
land_units_onscreen_name_Eas_Parthian_Horse_Archers	Parthian Horse Archers	true
land_units_onscreen_name_Car_Libyan_Peltasts	Libyan Peltasts	true
land_units_onscreen_name_Mer_Ibe_Lusitani_Swordswomen	Mercenary Lusitani Swordswomen	true
land_units_onscreen_name_3c_Aux_Germanic_Axe_Warriors	Auxiliary Germanic Axe Warriors	true
land_units_onscreen_name_3c_Ger_Germanic_Axe_Warriors	Germanic Axe Warriors	true
land_units_onscreen_name_Eas_Ballista	Eastern Ballista	true
land_units_onscreen_name_Gre_Scorpion_Bastion	Greek Bastion Scorpion	true
land_units_onscreen_name_Ibe_Scorpion_Bastion	Iberian Bastion Scorpion	true
land_units_onscreen_name_3c_Sas_Armoured_Indian_War_Elephants	Armoured Indian War Elephants	true
land_units_onscreen_name_3c_Aux_Persian_Cavalry	Auxiliary Persian Cavalry	true
land_units_onscreen_name_Ill_Raiders	Illyrian Raiders	true
land_units_onscreen_name_Rom_Legatus	Legatus	true
land_units_onscreen_name_Afr_Cheiroballistra	African Scorpion	true
land_units_onscreen_name_Ita_Levy_Slingers	Levy Slingers	true
land_units_onscreen_name_inv_apulian_archers	Native Iapygian Archers	true
land_units_onscreen_name_Rom_Plebs	Plebs	true
land_units_onscreen_name_3c_Ger_Germanic_Horse_Skirmishers	Germanic Horse Skirmishers	true
land_units_onscreen_name_dk_nab_nabatean_axe_warriors	Nabataean Axe Warriors	true
land_units_onscreen_name_Gre_Citizen_Hoplites	Citizen Hoplites	true
land_units_onscreen_name_3c_Cel_Celtic_Spearmen	Celtic Spearmen	true
land_units_onscreen_name_3c_Ala_Alani_Royal_Horses	Alani Royal Horses	true
land_units_onscreen_name_3c_Gal_Gallic_Warriors	Gallic Warriors	true
land_units_onscreen_name_3c_Sax_Saxon_Mounted_Warband	Saxoni Mounted Warband	true
land_units_onscreen_name_Mer_Ibe_Scutarii_Cav	Mercenary Scutarii Cavalry	true
land_units_onscreen_name_Afr_Ballista	African Ballista	true
land_units_onscreen_name_Car_Ballista	Carthaginian Ballista	true
land_units_onscreen_name_Ger_Ballista	German Ballista	true
land_units_onscreen_name_3c_Rom_Vigiles	Vigiles	true
land_units_onscreen_name_Thr_Peltasts	Thracian Peltasts	true
land_units_onscreen_name_3c_Rom_Pikemen	Pikemen	true
land_units_onscreen_name_Cel_Cheiroballistra	Celtic Scorpion	true
land_units_onscreen_name_Rom_Beehive_Onager	Roman Beehive Onager	true
land_units_onscreen_name_Ger_Cheiroballistra	German Scorpion	true
land_units_onscreen_name_Aux_Thr_Cav	Auxiliary Thracian Cavalry	true
land_units_onscreen_name_Ger_Sword_Masters	Sword Masters	true
land_units_onscreen_name_Ste_Spear	Steppe Spearmen	true
land_units_onscreen_name_Ibe_Spear	Iberian Spearmen	true
land_units_onscreen_name_Ill_Spear	Illyrian Spearmen	true
land_units_onscreen_name_Ita_Spear	Italian Spearmen	true
land_units_onscreen_name_Num_Spear	Numidian Spearmen	true
land_units_onscreen_name_Eas_Spear	Eastern Spearmen	true
land_units_onscreen_name_inv_gre_hippotoxotes	Hippotoxotes	true
land_units_onscreen_name_Ita_Samnite_Warriors	Samnite Warriors	true
land_units_onscreen_name_Ger_Slingers	Germanic Slingers	true
land_units_onscreen_name_Thr_Slingers	Thracian Slingers	true
land_units_onscreen_name_Bri_Scorpion	Briton Scorpion (Fixed)	true
land_units_onscreen_name_Mer_Gre_Gorgos_Skirmishers	Mercenary Gorgo's Skirmishers	true
land_units_onscreen_name_Gre_Hippeus_Lancers	Hippeus Lancers	true
land_units_onscreen_name_Pel_Picked_Hoplites	Picked Hoplites	true
land_units_onscreen_name_inv_iol_nuragic_shield_wall	Nuragic Shield Wall	true
land_units_onscreen_name_3c_Marc_Armoured_Germanic_Axe_Warriors	Armoured Germanic Axe Warriors	true
land_units_onscreen_name_Ibe_Painted_Warriors	Painted Warriors	true
land_units_onscreen_name_3c_Sas_Pushtighban_Cataphracts	Pushtigban Cataphracts	true
land_units_onscreen_name_3c_Mer_Persian_Archers	Mercenary Persian Archers	true
land_units_onscreen_name_3c_Per_Persian_Archers	Persian Archers	true
land_units_onscreen_name_3c_Eas_Eastern_Cavalry	Eastern Cavalry	true
land_units_onscreen_name_Eas_Slingers	Eastern Slingers	true
land_units_onscreen_name_3c_Ger_Germanic_Skirmishers	Germanic Skirmishers	true
land_units_onscreen_name_inv_african_cavalry	African Cavalry	true
land_units_onscreen_name_inv_carthaginian_infantry	Native Carthaginian Infantry	true
land_units_onscreen_name_Rom_Hastati	Hastati	true
land_units_onscreen_name_Mer_Gre_Citizen_Cav	Mercenary Citizen Cavalry	true
land_units_onscreen_name_Eas_Garrison_Spear	Eastern Spearmen	true
land_units_onscreen_name_inv_mercenary_naked_warriors	Mercenary Naked Warriors	true
land_units_onscreen_name_3c_Aux_Libyan_Infantry	Auxiliary Libyan Infantry	true
land_units_onscreen_name_Mer_Rom_Gladiatrices	Mercenary Gladiatrices	true
land_units_onscreen_name_inv_iol_sardi_bowmen	Sardi Bowmen	true
land_units_onscreen_name_Aux_Ita_Socii_Equites_Extraordinarii	Socii Equites Extraordinarii	true
land_units_onscreen_name_Gre_Massilian_Thureos_Spears	Massilian Thureos Spears	true
land_units_onscreen_name_3c_Aux_Indian_War_Elephants	Auxiliary Indian War Elephants	true
land_units_onscreen_name_Rom_Equites	Equites	true
land_units_onscreen_name_Ibe_Cheiroballistra	Iberian Scorpion	true
land_units_onscreen_name_Ger_Wolf_Warriors	Wolf Warriors	true
land_units_onscreen_name_inv_iol_nuragic_ambushers	Nuragic Ambushers	true
land_units_onscreen_name_3c_Per_Persian_Levy	Persian Levy	true
land_units_onscreen_name_Cel_Tribal_Warriors	Tribal Warriors	true
land_units_onscreen_name_3c_Ger_Germanic_Nobles_comm	Germanic Nobles Bodyguard	true
land_units_onscreen_name_3c_Ala_Armoured_Axe_Warriors	Armoured Axe Warriors	true
land_units_onscreen_name_3c_Arm_Armoured_Axe_Warriors	Armoured Axe Warriors	true
land_units_onscreen_name_dk_mer_nubian_bowmen	Mercenary Nubian Bowmen	true
land_units_onscreen_name_3c_Sas_Kurdish_Archers	Kurdish Archers	true
land_units_onscreen_name_Gre_Thureos_Spears	Thureos Spears	true
land_units_onscreen_name_Aux_Ill_Cav	Auxiliary Illyrian Cavalry	true
land_units_onscreen_name_Pel_Spartan_Archer_Marines	Spartan Archer Marines	true
land_units_onscreen_name_Dac_Cheiroballistra	Dacian Scorpion	true
land_units_onscreen_name_Car_Cheiroballistra	Carthaginian Scorpion	true
land_units_onscreen_name_Eas_Cheiroballistra	Eastern Scorpion	true
land_units_onscreen_name_inv_mercenary_etr_archers	Mercenary Etruscan Archers	true
land_units_onscreen_name_Ara_Camel_Archers	Camel Archers	true
land_units_onscreen_name_inv_greek_archers	Native Greek Archers	true
land_units_onscreen_name_inv_greek_militia	Native Greek Militia	true
land_units_onscreen_name_Rom_Leves	Leves	true
land_units_onscreen_name_inv_iol_sherden_swordsmen	Sherden Swordsmen	true
land_units_onscreen_name_inv_ita_umbrian_defenders	Umbrian Defenders	true
land_units_onscreen_name_3c_Rom_Armoured_Horse_Skirmishers	Armoured Horse Skirmishers	true
land_units_onscreen_name_Gre_Scythed_Chariots	Scythed Chariots	true
land_units_onscreen_name_3c_Aux_Celtic_Horsemen	Auxiliary Celtic Horsemen	true
land_units_onscreen_name_3c_Aux_Steppe_Warriors	Auxiliary Steppe Warriors	true
land_units_onscreen_name_3c_Pal_Palmyrene_Legionaries	Palmyrene Legionaries 	true
land_units_onscreen_name_Dac_Scorpion_Bastion	Dacian Bastion Scorpion	true
land_units_onscreen_name_Egy_Infantry	Egyptian Infantry	true
land_units_onscreen_name_Rom_Scorpion	Roman Scorpion (Fixed)	true
land_units_onscreen_name_Pel_Hippeus	Hippeus	true
land_units_onscreen_name_3c_Zenobia_Chariots	Zenobia	true
land_units_onscreen_name_Gre_Pergamon_Noble_Cavalry	Pergamenes Noble Cavalry	true
land_units_onscreen_name_Gre_Ptolemaic_Cav	Ptolemaic Cavalry	true
land_units_onscreen_name_3c_Ste_Steppe_Spearmen	Steppe Spearmen	true
land_units_onscreen_name_3c_Sab_Sabean_Armoured_Spearmen_comm	Sabean Armoured Spearmen Bodyguard	true
land_units_onscreen_name_inv_iol_sardi_axemen	Sardi Axemen	true
land_units_onscreen_name_3c_Ste_Steppe_Warriors	Steppe Warriors	true
land_units_onscreen_name_3c_Aux_Iberian_Cavalry	Auxiliary Iberian Cavalry	true
land_units_onscreen_name_Cel_Warriors	Celtic Warriors	true
land_units_onscreen_name_3c_Ara_Arabian_Camel_Archers_comm	Arabian Camel Archers Bodyguard	true
land_units_onscreen_name_3c_Cel_Chariots_comm	Chariots Bodyguard	true
land_units_onscreen_name_Aux_Infantry	Auxiliary Infantry	true
land_units_onscreen_name_Cel_Scorpion	Celtic Scorpion (Fixed)	true
land_units_onscreen_name_Rom_Cheiroballistra	Roman Scorpion	true
land_units_onscreen_name_Eas_Persian_Cavalry	Persian Cavalry	true
land_units_onscreen_name_Afr_Large_Shield_Warriors	Large Shield Warriors	true
land_units_onscreen_name_Mer_Ara_Cav	Mercenary Arabian Cavalry	true
land_units_onscreen_name_Aux_Ibe_Cav	Auxiliary Iberian Cavalry	true
land_units_onscreen_name_Gre_Periokoi_Pike	Perioikoi Pikemen	true
land_units_onscreen_name_Ill_Thureos_Spears	Illyrian Thureos Spears	true
land_units_onscreen_name_Pel_Phyrgian_Spear	Phyrgian Spearmen	true
land_units_onscreen_name_3c_Goth_Gothic_Spearwomen	Gothic Spearwomen	true
land_units_onscreen_name_inv_car_carthaginian_cavalry	Carthaginian Cavalry	true
land_units_onscreen_name_3c_Mer_Sabean_Spearmen	Mercenary Sabean Spearmen	true
land_units_onscreen_name_Rom_Scorpion_Bastion	Roman Bastion Scorpion	true
land_units_onscreen_name_3c_Aux_Eastern_Pikemen	Auxiliary Eastern Pikemen	true
land_units_onscreen_name_Dac_Scorpion	Dacian Scorpion (Fixed)	true
land_units_onscreen_name_3c_Sas_Kurdish_Archers_comm	Kurdish Archers Bodyguard	true
land_units_onscreen_name_Aux_Ara_Spr	Auxiliary Arabian Spearmen	true
land_units_onscreen_name_inv_italian_hillmen	Native Italian Hillmen	true
land_units_onscreen_name_Gre_Thorax_Hoplites	Thorax Hoplites	true
land_units_onscreen_name_3c_Rom_Vigiles_comm	Vigiles Bodyguard	true
land_units_onscreen_name_Ger_Cimbri_Bowwomen	Cimbri Bow-Women	true
land_units_onscreen_name_3c_Goth_Greuthungi_Elite_Spears_comm	Greuthungi Elite Spears Bodyguard	true
land_units_onscreen_name_inv_italian_slingers	Native Italian Slingers	true
land_units_onscreen_name_Cel_Scorpion_Bastion	Celtic Bastion Scorpion	true
land_units_onscreen_name_3c_Bri_Cheiroballistra	Briton Scorpion	true
land_units_onscreen_name_Egy_Slingers	Egyptian Slingers	true
land_units_onscreen_name_3c_Sas_Armoured_Indian_War_Elephants_comm	Armoured Indian War Elephants Bodyguard	true
land_units_onscreen_name_Bac_Scale_Thorax_Hoplites	Scale Thorax Hoplites	true
land_units_onscreen_name_Rom_Triarii	Triarii	true
land_units_onscreen_name_Ste_Archers	Steppe Archers	true
land_units_onscreen_name_Egy_Galatian_Sword	Galatian Swordsmen	true
land_units_onscreen_name_3c_Sas_Royal_Archers	Royal Archers	true
land_units_onscreen_name_3c_Rom_Equites_Catafractarii_comm	Equites Catafractarii Bodyguard	true
land_units_onscreen_name_3c_Pal_Imperial_Pikemen_comm	Imperial Pikemen Bodyguard	true
land_units_onscreen_name_3c_Arm_Azat_Knights	Azat Knights	true
land_units_onscreen_name_Eas_Pontic_Peltasts	Pontic Peltasts	true
land_units_onscreen_name_inv_sardi_hillmen	Native Sardi Hillmen	true
land_units_onscreen_name_Aux_Ibe_Scutarii_Cav	Auxiliary Scutarii Cavalry	true
land_units_onscreen_name_3c_Ger_Test_Infantry	Test Infantry	true
land_units_onscreen_name_Pel_Armoured_Marines	Armoured Marines	true
land_units_onscreen_name_3c_Mer_Germanic_Band	Mercenary Germanic Band	true
land_units_onscreen_name_3c_Mer_Hillmen	Mercenary Hillmen	true
land_units_onscreen_name_3c_Ger_Germanic_Band	Germanic Band	true
land_units_onscreen_name_Pel_Immortal_Archers	Immortal Archers	true
land_units_onscreen_name_dk_nab_rekem_palace_guard	Rekem Palace Guard	true
land_units_onscreen_name_Gre_Archers	Archers	true
land_units_onscreen_name_Afr_Chariot_Raiders	Chariot Raiders	true
land_units_onscreen_name_Aux_Afr_Cav	Auxiliary Sabaean Cavalry	true
land_units_onscreen_name_Pel_Helot_Archers	Helot Archers	true
land_units_onscreen_name_inv_sam_italian_horse_skirmishers	Italian Horse Skirmishers	true
land_units_onscreen_name_Gre_Helot_Archers	Helot Archers	true
land_units_onscreen_name_Car_Libyan_Infantry	Libyan Infantry	true
land_units_onscreen_name_Ger_Night_Hunters	Night Hunters	true
land_units_onscreen_name_3c_Sab_Sabean_Spearmen	Sabean Spearmen	true
land_units_onscreen_name_inv_mercenary_latin_warriors	Mercenary Latin Warriors	true
land_units_onscreen_name_3c_Sas_Zhayedan_Immortals	Zhayedan Immortals	true
land_units_onscreen_name_3c_Sas_Elite_Savaran_Cavalry	Elite Savaran Cavalry	true
land_units_onscreen_name_3c_Marc_Germanic_Noble_Guard_comm	Germanic Noble Bodyguard	true
land_units_onscreen_name_dk_nab_heavy_desert_spearmen	Heavy Desert Spearmen	true
land_units_onscreen_name_Bri_Scorpion_Bastion	Briton Bastion Scorpion	true
land_units_onscreen_name_Car_Hoplites	Carthaginian Hoplites	true
land_units_onscreen_name_inv_mercenary_cretan_archers	Mercenary Cretan Archers	true
land_units_onscreen_name_Car_Libyan_Hoplites	Libyan Hoplites	true
land_units_onscreen_name_Gre_Tarantine_Cav	Tarantine Cavalry	true
land_units_onscreen_name_inv_mercenary_ill_raiders	Mercenary Illyrian Raiders	true
land_units_onscreen_name_3c_Mer_Steppe_Slingers	Mercenary Steppe Slingers	true
land_units_onscreen_name_Pel_Spartan_Marines	Spartan Marines	true
land_units_onscreen_name_3c_Sas_Indian_War_Elephants	Indian War Elephants	true
land_units_onscreen_name_3c_Aux_Germanic_Skirmishers	Auxiliary Germanic Skirmishers	true
land_units_onscreen_name_Mer_Ita_Cav	Mercenary Italian Cavalry	true
land_units_onscreen_name_Ger_Wodanaz_Spears	Wodanaz Spears	true
land_units_onscreen_name_3c_Aux_Illyrian_Swordsmen	Auxiliary Illyrian Swordsmen	true
land_units_onscreen_name_3c_Mer_Camel_Archers	Mercenary Camel Archers	true
land_units_onscreen_name_3c_Aux_Camel_Archers	Auxiliary Camel Archers	true
land_units_onscreen_name_3c_Ala_Noble_Steppe_Cataphracts_comm	Noble Steppe Cataphracts Bodyguard	true
land_units_onscreen_name_3c_Sas_Camel_Archers	Camel Archers	true
land_units_onscreen_name_3c_Marc_Germanic_Noble_Guard	Germanic Noble Guard	true
land_units_onscreen_name_Aux_Ind_War_Elephant	Auxiliary Indian War Elephants	true
land_units_onscreen_name_Thr_Horsemen	Thracian Horsemen	true
land_units_onscreen_name_Gre_Scorpion	Greek Scorpion (Fixed)	true
land_units_onscreen_name_Ibe_Scorpion	Iberian Scorpion (Fixed)	true
land_units_onscreen_name_Eas_Ballista_Bastion	Eastern Bastion Ballista	true
land_units_onscreen_name_3c_Mer_Indian_War_Elephants	Mercenary Indian War Elephants	true
land_units_onscreen_name_Mer_Num_Cav	Mercenary Numidian Cavalry	true
land_units_onscreen_name_3c_Marc_Wodanaz_Spears_comm	Wodanaz Spears Bodyguard	true
land_units_onscreen_name_3c_Ger_Test_Cavalry	Test Cavalry	true
land_units_onscreen_name_Aux_Per_Cav	Auxiliary Persian Cavalry	true
land_units_onscreen_name_3c_Eas_Hillmen	Hillmen	true
land_units_onscreen_name_3c_Rom_Equites_Dalmatarum	Equites Dalmatarum	true
land_units_onscreen_name_Pel_Skiritai	Skiritai	true
land_units_onscreen_name_3c_Pal_Hillmen	Hillmen	true
land_units_onscreen_name_Afr_Ballista_Bastion	African Bastion Ballista	true
land_units_onscreen_name_Car_Ballista_Bastion	Carthaginian Bastion Ballista	true
land_units_onscreen_name_Ger_Ballista_Bastion	German Bastion Ballista	true
land_units_onscreen_name_Eas_Axemen	Axemen	true
land_units_onscreen_name_inv_mercenary_ill_hoplites	Mercenary Illyrian Hoplites	true
land_units_onscreen_name_Eas_Onager_Bastion	Eastern Bastion Onager	true
land_units_onscreen_name_Mer_Cel_Warhounds	Mercenary Celtic Warhounds	true
land_units_onscreen_name_Pel_Royal_Spartans	Royal Spartans	true
land_units_onscreen_name_inv_ven_veneti_ekuperatis	Veneti Ekupetaris	true
land_units_onscreen_name_Gre_Royal_Peltasts	Royal Peltasts	true
land_units_onscreen_name_3c_Ste_Steppe_Nobles	Steppe Nobles	true
land_units_onscreen_name_inv_brutii_tribesmen	Native Bruttii Tribesmen	true
land_units_onscreen_name_3c_Aux_Alae_Clibanarii	Alae Clibanarii	true
land_units_onscreen_name_3c_Goth_Gothic_Lancers	Gothic Lancers	true
land_units_onscreen_name_Mer_Num_Noble_Cav	Mercenary Numidian Noble Cavalry	true
land_units_onscreen_name_Ill_Levies	Illyrian Levies	true
land_units_onscreen_name_Gre_Thessalian_Cav	Thessalian Cavalry	true
land_units_onscreen_name_Dac_Onager_Bastion	Dacian Bastion Onager	true
land_units_onscreen_name_Gre_Helot_Slingers	Helot Slingers	true
land_units_onscreen_name_3c_Cal_Caledonian_Heroic_Riders_comm	Heroic Riders Bodyguard	true
land_units_onscreen_name_Rom_Legionary_Cohort	Legionary Cohort	true
land_units_onscreen_name_dk_nab_nabatean_thorax_pikes	Nabataean Thorax Pikes	true
land_units_onscreen_name_Gre_Agrianian_Axemen	Agrianian Axemen	true
land_units_onscreen_name_Cel_Galatian_Spears	Galatian Spears	true
land_units_onscreen_name_Gre_Onager_Bastion	Greek Bastion Onager	true
land_units_onscreen_name_Ibe_Onager	Iberian Onager	true
land_units_onscreen_name_Ger_Onager_Bastion	German Bastion Onager	true
land_units_onscreen_name_3c_Ste_Steppe_Slingers_comm	Steppe Slingers Bodyguard	true
land_units_onscreen_name_Dac_Bowmen	Dacian Bowmen	true
land_units_onscreen_name_inv_sen_tribeless_slingers	Tribeless Slingers	true
land_units_onscreen_name_Mer_Ita_Etruscan_Hoplites	Mercenary Etruscan Hoplites	true
land_units_onscreen_name_Ste_Sarmatian_Royal_Lancers	Sarmatian Royal Lancers	true
land_units_onscreen_name_3c_Rom_Gladiators	Gladiators	true
land_units_onscreen_name_inv_sam_lucanian_warriors	Lucanian Warriors	true
land_units_onscreen_name_3c_Aux_Celtic_Heavy_Cavalry	Auxiliary Celtic Heavy Cavalry	true
land_units_onscreen_name_Eas_Kartli_Axemen	Kartli Axemen	true
land_units_onscreen_name_Ibe_Giant_Ballista	Iberian Giant Ballista	true
land_units_onscreen_name_Cel_Spear_Warriors	Spear Warriors	true
land_units_onscreen_name_3c_Ara_Arabian_Camel_Archers	Arabian Camel Archers	true
land_units_onscreen_name_3c_Aux_Arabian_Camel_Archers	Auxiliary Arabian Camel Archers	true
land_units_onscreen_name_3c_Eas_Eastern_Horse_Archers	Eastern Horse Archers	true
land_units_onscreen_name_3c_Sas_Eastern_Horse_Archers	Eastern Horse Archers	true
land_units_onscreen_name_Gre_Cretan_Archers	Cretan Archers	true
land_units_onscreen_name_Afr_Onager_Bastion	African Bastion Onager	true
land_units_onscreen_name_3c_Rom_Roman_Levies	Roman Levies	true
land_units_onscreen_name_Dac_Spears	Spears	true
land_units_onscreen_name_dk_nab_hellenic_desert_cataphracts	Hellenic Desert Cataphracts	true
land_units_onscreen_name_Egy_Sobek_Cultists	Sobek Cultists	true
land_units_onscreen_name_Dac_Spear_Warriors	Spear Warriors	true
land_units_onscreen_name_3c_Cel_Celtic_Nobles	Celtic Nobles	true
land_units_onscreen_name_3c_Sas_Anatolian_Slingers	Anatolian Slingers	true
land_units_onscreen_name_3c_Per_Persian_Horse_Archers	Persian Horse Archers	true
land_units_onscreen_name_3c_Sas_Persian_Horse_Archers	Persian Horse Archers	true
land_units_onscreen_name_Cel_Bowmen	Celtic Bowmen	true
land_units_onscreen_name_inv_sen_gallic_skirmishers	Gallic Skirmishers	true
land_units_onscreen_name_inv_mercenary_carthaginian_javelin	Mercenary Carthaginian Javelinmen	true
land_units_onscreen_name_3c_Ala_Steppe_Horse_Archers	Steppe Horse Archers	true
land_units_onscreen_name_Ill_Slave_Slingers	Slave Slingers	true
land_units_onscreen_name_3c_Rom_Roman_Legionary_Cavalry	Roman Legionary Cavalry	true
land_units_onscreen_name_3c_Eas_Eastern_Infantry_comm	Eastern Infantry Bodyguard	true
land_units_onscreen_name_Aux_Ita_Socii_Extraordinarii	Socii Extraordinarii	true
land_units_onscreen_name_Gre_Cimmerian_Noble_Infantry	Cimmerian Noble Infantry	true
land_units_onscreen_name_Aux_Bri_Scout_Riders	Auxiliary Briton Scout Riders	true
land_units_onscreen_name_Ste_Sarmatian_Riders	Sarmatian Riders	true
land_units_onscreen_name_3c_Sas_Royal_Sassanian_Archers_comm	Royal Sassanian Archers Bodyguard	true
land_units_onscreen_name_3c_Ala_Alani_Nobles	Alani Nobles	true
land_units_onscreen_name_Cel_Onager_Bastion	Celtic Bastion Onager	true
land_units_onscreen_name_Car_Onager_Bastion	Carthaginian Bastion Onager	true
land_units_onscreen_name_3c_Eas_Large_Onager	Eastern Large Onager	true
land_units_onscreen_name_dk_saba_sabaean_camel_cataphracts	Sabaean Camel Cataphracts	true
land_units_onscreen_name_Gre_Light_Peltasts	Light Peltasts	true
land_units_onscreen_name_Mer_Ara_Camel_Spear	Mercenary Camel Spearmen	true
land_units_onscreen_name_3c_Cal_Caledonian_Oathsworn	Caledonii Oathsworn	true
land_units_onscreen_name_3c_Mer_Sarmatian_Light_Cavalry	Mercenary Sarmatian Light Cavalry	true
land_units_onscreen_name_3c_Cel_Painted_Warriors_comm	Painted Warriors Bodyguard	true
land_units_onscreen_name_3c_Ala_Armoured_Steppe_Warriors_comm	Armoured Steppe Warriors Bodyguard	true
land_units_onscreen_name_3c_Rom_Equites_Catafractarii	Equites Catafractarii	true
land_units_onscreen_name_Bri_Onager_Bastion	Briton Bastion Onager	true
land_units_onscreen_name_inv_sam_armoured_spearmen	Samnite Armoured Spearmen	true
land_units_onscreen_name_Car_Libyan_Javelin	Libyan Javelinmen	true
land_units_onscreen_name_3c_Afr_Large_Onager	African Heavy Onager	true
land_units_onscreen_name_3c_Ger_Large_Onager	German Heavy Onager	true
land_units_onscreen_name_inv_rom_principes	Principes	true
land_units_onscreen_name_Mer_Rom_Gladiatrices_Spear	Mercenary Spear Gladiatrices	true
land_units_onscreen_name_Car_Onager	Carthaginian Onager	true
land_units_onscreen_name_Mer_Afr_Elephants	Mercenary African Elephants	true
land_units_onscreen_name_Cel_Onager	Celtic Onager	true
land_units_onscreen_name_Afr_War_Elephants	African War Elephants	true
land_units_onscreen_name_Ind_War_Elephants	Indian War Elephants	true
land_units_onscreen_name__test_dummy	Test Dummy	true
land_units_onscreen_name_Cel_Naked_Warriors	Naked Warriors	true
land_units_onscreen_name_Bri_Giant_Ballista	Briton Giant Ballista	true
land_units_onscreen_name_Rom_Praetorian_Guard	Praetorian Guard	true
land_units_onscreen_name_Cel_Celtic_Warhounds	Celtic Warhounds	true
land_units_onscreen_name_3c_Pal_Palmyrene_Legionaries_comm	Palmyrene Legionaries Bodyguard	true
land_units_onscreen_name_3c_Rom_Praetorian_Cavalry	Praetorian Cavalry 	true
land_units_onscreen_name_Bri_Onager	Briton Onager	true
land_units_onscreen_name_3c_Ala_Alani_Axemen	Alani Axemen	true
land_units_onscreen_name_Cel_Giant_Ballista	Celtic Giant Ballista	true
land_units_onscreen_name_Car_Giant_Ballista	Carthaginian Giant Ballista	true
land_units_onscreen_name_Mer_Gal_Noble_Horse	Mercenary Noble Horse	true
land_units_onscreen_name_inv_sam_light_spearmen_ver_sacrum	Ver Sacrum Spearmen	true
land_units_onscreen_name_dk_saba_sabaean_swordsmen	Sabaean Swordsmen	true
land_units_onscreen_name_3c_Gal_Gallic_Light_Cavalry	Gallic Light Cavalry	true
land_units_onscreen_name_3c_Aux_Germanic_Heavy_Infantry	Auxiliary Germanic Heavy Infantry	true
land_units_onscreen_name_Ind_Armour_Elephants	Indian Armoured Elephants	true
land_units_onscreen_name_Afr_Onager	African Onager	true
land_units_onscreen_name_Ibe_Cantabrian_Cav	Cantabrian Cavalry	true
land_units_onscreen_name_inv_mercenary_ligurian_axe_warriors	Mercenary Ligurian Axe Warriors	true
land_units_onscreen_name_inv_latin_spearmen	Native Latin Spearmen	true
land_units_onscreen_name_dk_kush_african_elephants	African Elephants	true
land_units_onscreen_name_inv_iol_iolean_javelinmen	Iolean Javelinmen	true
land_units_onscreen_name_3c_Marc_Club_Levy	Club Levy	true
land_units_onscreen_name_test_test	Test Unit	true
land_units_onscreen_name_Cel_Gallic_Hunters	Gallic Hunters	true
land_units_onscreen_name_inv_ill_tribesmen	Illyrian Tribesmen	true
land_units_onscreen_name_inv_ven_ambushers	Veneti Ambushers	true
land_units_onscreen_name_dk_saba_marib_royal_guard	Ma'rib Royal Guard	true
land_units_onscreen_name_Afr_Giant_Ballista	African Giant Ballista	true
land_units_onscreen_name_Gre_Light_Hoplites	Light Hoplites	true
land_units_onscreen_name_Mer_Cel_Light_Horse	Mercenary Celtic Light Horse	true
land_units_onscreen_name_3c_Sas_Daylamite_Infantry	Daylamite Infantry	true
land_units_onscreen_name_3c_Goth_Tervingi_Warriors	Tervingi Warriors	true
land_units_onscreen_name_3c_Eas_Onager_Shp	Eastern Onager (Ship)	true
land_units_onscreen_name_3c_Sas_Immortal_Spears	Immortal Spears	true
land_units_onscreen_name_3c_Gal_Gallic_Legionaries	Gallic Legionaries 	true
land_units_onscreen_name_Ger_Onager	German Onager	true
land_units_onscreen_name_Ibe_Onager_Bastion	Iberian Bastion Onager	true
land_units_onscreen_name_Pel_Thr_Royal_Cav	Thraike Royal Cavalry	true
land_units_onscreen_name_Gre_Onager	Greek Onager	true
land_units_onscreen_name_inv_mercenary_sardi_bowmen	Mercenary Sardi Bowmen	true
land_units_onscreen_name_3c_Pal_Veteran_Palmyrene_Legionaries	Veteran Palmyrene Legionaries 	true
land_units_onscreen_name_dk_ara_desert_heavy_lancers	Desert Heavy Lancers	true
land_units_onscreen_name_3c_Ala_Alani_Riders	Alani Riders	true
land_units_onscreen_name_inv_aequi_swordsmen	Native Aequi Swordsmen	true
land_units_onscreen_name_dk_saba_royal_marib_cavalry	Royal Ma'rib Cavalry	true
land_units_onscreen_name_Ger_Giant_Ballista	German Giant Ballista	true
land_units_onscreen_name_Ara_Tribes_People	Tribes People	true
land_units_onscreen_name_Gre_Giant_Ballista	Greek Giant Ballista	true
land_units_onscreen_name_3c_Ste_Steppe_Nobles_comm	Steppe Nobles Bodyguard	true
land_units_onscreen_name_inv_sam_italian_hillmen_ver_sacrum	Ver Sacrum Swordsmen	true
land_units_onscreen_name_Dac_Armoured_Spears	Armoured Spears	true
land_units_onscreen_name_Eas_Onager	Eastern Onager	true
land_units_onscreen_name_Cel_Gallo_Thracian_Infantry	Gallo-Thracian Infantry	true
land_units_onscreen_name_Pel_Median_Cavalry	Median Cavalry	true
land_units_onscreen_name_Gre_Shield_Bearers	Shield Bearers	true
land_units_onscreen_name_Mer_Ita_Campanian_Cavalry	Mercenary Campanian Cavalry	true
land_units_onscreen_name_Gre_Cimmerian_Heavy_Archers	Cimmerian Heavy Archers	true
land_units_onscreen_name_Dac_Giant_Ballista	Dacian Giant Ballista	true
land_units_onscreen_name_3c_Mer_Sarmatian_Horse_Archers	Mercenary Sarmatian Horse Archers	true
land_units_onscreen_name_3c_Ala_Alani_Horse_Skirmishers	Alani Horse Skirmishers	true
land_units_onscreen_name_3c_Marc_Longbow_Hunters_comm	Longbow Hunters Bodyguard	true
land_units_onscreen_name_3c_Ala_Armoured_Steppe_Lancers	Armoured Steppe Lancers	true
land_units_onscreen_name_Dac_Onager	Dacian Onager	true
land_units_onscreen_name_dk_num_heavy_numidian_skirmishers	Heavy Numidian Skirmishers	true
land_units_onscreen_name_3c_Sas_Immortal_Spear_Guard	Immortal Spear Guard	true
land_units_onscreen_name_inv_rom_horse_skirmishers	Horse Skirmishers	true
land_units_onscreen_name_Eas_Giant_Ballista	Eastern Giant Ballista	true
land_units_onscreen_name_inv_etr_horse_skirmishers	Italian Horse Skirmishers	true
land_units_onscreen_name_inv_gre_horse_skirmishers	Horse Skirmishers	true
land_units_onscreen_name_inv_app_horse_skirmishers	Iapygian Horse Skirmishers	true
land_units_onscreen_name_Mer_Gal_Light_Horse	Mercenary Gallic Light Horse	true
land_units_onscreen_name_Mer_Bac_Light_Horse	Mercenary Bactrian Light Horse	true
land_units_onscreen_name_inv_ita_horse_skirmishers	Italian Horse Skirmishers	true
land_units_onscreen_name_Gre_Pontic_Royal_Cav	Pontic Royal Cavalry	true
land_units_onscreen_name_Mer_Bri_Scout_Riders	Mercenary Briton Scout Riders	true
land_units_onscreen_name_dk_ara_desert_levy	Desert Levy	true
land_units_onscreen_name_Num_Noble_Infantry	Numidian Noble Infantry	true
land_units_onscreen_name_inv_tar_tarantine_cavalry	Tarantine Cavalry	true
land_units_onscreen_name_3c_Pal_Palmyrene_Spearmen	Palmyrene Spearmen	true
land_units_onscreen_name_3c_Mer_Light_Roman_Skirmishers	Mercenary Light Roman Skirmishers	true
land_units_onscreen_name_3c_Mer_Gallic_Bowmen	Mercenary Gallic Bowmen	true
land_units_onscreen_name_3c_Aux_Gallic_Bowmen	Auxiliary Gallic Bowmen	true
land_units_onscreen_name_inv_mercenary_eques	Mercenary Eques	true
land_units_onscreen_name_Pel_Archer_Marines	Archer Marines	true
land_units_onscreen_name_inv_ita_italic_skirmishers	Italian Skirmishers	true
land_units_onscreen_name_Gre_Colchian_Nobles	Colchian Nobles	true
land_units_onscreen_name_Eas_Noble_Blood_Cav	Noble Blood Cavalry	true
land_units_onscreen_name_Aux_Ibe_Balearic_Slingers	Auxiliary Balearic Slingers	true
land_units_onscreen_name_Gre_Molossian_Dogs	Molossian Dogs	true
land_units_onscreen_name_Mer_Ibe_Balearic_Slingers	Mercenary Balearic Slingers	true
land_units_onscreen_name_3c_Sas_Royal_Sassanian_Archers	Royal Sassanian Archers	true
land_units_onscreen_name_Gre_Helot_Javelinmen	Helot Javelinmen	true
land_units_onscreen_name_Mer_Scy_Armour_Horse_Archers	Mercenary Armoured Horse Archers	true
land_units_onscreen_name_Aux_Syrian_Archers	Auxiliary Syrian Archers	true
land_units_onscreen_name_3c_Goth_Gothic_Night_Riders	Gothic Night Riders	true
land_units_onscreen_name_inv_local_campanian_cavalry	Native Campanian Cavalry	true
land_units_onscreen_name_Thr_Bowmen	Thracian Bowmen	true
land_units_onscreen_name_inv_mercenary_carthaginian_hoplites	Mercenary Carthaginian Hoplites	true
land_units_onscreen_name_Rom_Gladiator_Spear	Gladiator Spearmen	true
land_units_onscreen_name_dk_saba_royal_camel_archers	Royal Camel Archers	true
land_units_onscreen_name_3c_Mer_Gallic_Heavy_Infantry	Mercenary Gallic Heavy Infantry	true
land_units_onscreen_name_3c_Aux_Gallic_Heavy_Infantry	Auxiliary Gallic Heavy Infantry	true
land_units_onscreen_name_Ibe_Lusitani_Nobles	Lusitani Nobles	true
land_units_onscreen_name_dk_saba_mer_himyar_cavalry	Mercenary Himyar Cavalry	true
land_units_onscreen_name_Cel_Youths	Celtic Youths	true
land_units_onscreen_name_inv_mercenary_artas'_chosen	Mercenary Artas' Chosen	true
land_units_onscreen_name_Gre_Periokoi_Spears	Perioikoi Spears	true
land_units_onscreen_name_Dac_Spear_Horsemen	Spear Horsemen	true
land_units_onscreen_name_Aux_Cel_Naked_Swords	Auxiliary Naked Swords	true
land_units_onscreen_name_3c_Sax_Saxon_Bows_comm	Saxoni Bows Bodyguard	true
land_units_onscreen_name_3c_Aux_Gallic_Skirmishers	Auxiliary Gallic Skirmishers	true
land_units_onscreen_name_3c_Goth_Gothic_Archers	Gothic Archers	true
land_units_onscreen_name_Cel_Galatian_Swords	Galatian Swords	true
land_units_onscreen_name_inv_sam_hirpinian_warriors	Hirpinian Warriors	true
land_units_onscreen_name_3c_Cel_Celtic_Nobles_comm	Celtic Nobles Bodyguard	true
land_units_onscreen_name_3c_Sax_Gedriht_Spearmen_comm	Gedriht Spearmen Bodyguard	true
land_units_onscreen_name_Mer_Ger_Scout_Riders	Mercenary Germanic Scout Riders	true
land_units_onscreen_name_3c_Arm_Azat_Guard_comm	Azat Guard Bodyguard	true
land_units_onscreen_name_3c_Cel_Wolfhounds	Wolfhounds	true
land_units_onscreen_name_3c_Rom_Roman_Legionary_Cavalry_comm	Roman Legionary Cavalry Bodyguard	true
land_units_onscreen_name_inv_mercenary_veneti_axemen	Mercenary Veneti Axemen	true
land_units_onscreen_name_test_placeholder_nuragic_warriors	Test Placeholder Nuragic Warriors	true
land_units_onscreen_name_dk_kush_kushite_royal_guard	Kushite Royal Guard	true
land_units_onscreen_name_3c_Sax_Saxon_Bows	Saxoni Bows	true
land_units_onscreen_name_3c_Cel_Celtic_Skirmishers	Celtic Skirmishers	true
land_units_onscreen_name_3c_Aux_Eastern_Heavy_Cavalry	Auxiliary Eastern Heavy Cavalry	true
land_units_onscreen_name_Ill_Slave_Javelinmen	Slave Javelinmen	true
land_units_onscreen_name_inv_sam_silver_infantryman	Samnite Silver Infantryman	true
land_units_onscreen_name_inv_tar_tarantine_hoplites	Tarantine Hoplites	true
land_units_onscreen_name_Pel_Helot_Slingers	Helot Slingers	true
land_units_onscreen_name_Ill_Noble_Hoplites	Illyrian Noble Hoplites	true
land_units_onscreen_name_Aux_Ara_Camel_Spear	Auxiliary Camel Spearmen	true
land_units_onscreen_name_Cel_Fierce_Swords	Fierce Swords	true
land_units_onscreen_name_Ibe_Noble_Fighters	Noble Fighters	true
land_units_onscreen_name_3c_Aux_Sarmatian_Light_Cavalry	Auxiliary Sarmatian Light Cavalry	true
land_units_onscreen_name_3c_Ala_Alani_Amazonian_Archers	Alani 'Amazonian' Archers	true
land_units_onscreen_name_Ste_Amazonian_Riders	Scythian 'Amazonian' Riders	true
land_units_onscreen_name_Eas_Persian_Light_Archers	Persian Light Archers	true
land_units_onscreen_name_Ger_Youths	Germanic Youths	true
land_units_onscreen_name_Rom_Onager_Bastion	Roman Bastion Onager	true
land_units_onscreen_name_Rom_Praetorian_Cav	Praetorian Cavalry	true
land_units_onscreen_name_Bri_Heroic_Nobles	Heroic Nobles	true
land_units_onscreen_name_Ita_Noble_Infantry	Italian Noble Infantry	true
land_units_onscreen_name_Gre_Royal_Spartans	Royal Spartans	true
land_units_onscreen_name_inv_aequi_horsemen	Native Aequi Horsemen	true
land_units_onscreen_name_Aux_Cel_Short_Swords	Auxiliary Short Swords	true
land_units_onscreen_name_dk_ara_caravan_guard	Caravan Guard	true
land_units_onscreen_name_inv_ven_veneti_heavy_cavalry	Veneti Heavy Cavalry	true
land_units_onscreen_name_3c_Ste_Sarmatian_Light_Cavalry	Sarmatian Light Cavalry	true
land_units_onscreen_name_3c_Ger_Germanic_Nobles	Germanic Nobles	true
land_units_onscreen_name_3c_Goth_Gothic_Falxmen	Gothic Falxmen	true
land_units_onscreen_name_Pel_Theban_Hippeus	Theban Hippeus	true
land_units_onscreen_name_3c_Rom_Large_Onager	Roman Heavy Onager	true
land_units_onscreen_name_Rom_Giant_Ballista	Roman Giant Ballista	true
land_units_onscreen_name_Aux_Eas_Horse_Skirm	Auxiliary Horse Skirmishers	true
land_units_onscreen_name_inv_iol_sardi_skirmishers	Sardi Skirmishers	true
land_units_onscreen_name_Ste_Saka_Cataphract_Horse_Archers	Saka Cataphract Horse Archers	true
land_units_onscreen_name_Pel_Helot_Javelinmen	Helot Javelinmen	true
land_units_onscreen_name_Rom_Onager	Roman Onager	true
land_units_onscreen_name_inv_veneti_raiders	Native Veneti Raiders	true
land_units_onscreen_name_inv_latin_tribesmen	Native Latin Tribesmen	true
land_units_onscreen_name_inv_rom_centuriae	Centuriae	true
land_units_onscreen_name_inv_sen_tribeless_spearmen	Tribeless Spearmen	true
land_units_onscreen_name_Aux_Gal_Noble_Horse	Auxiliary Noble Horse	true
land_units_onscreen_name_Dac_Noble_Horsemen	Noble Horsemen	true
land_units_onscreen_name_inv_sen_tribeless_warriors	Tribeless Warriors	true
land_units_onscreen_name_Mer_Cel_Naked_Swords	Mercenary Naked Swords	true
land_units_onscreen_name_3c_Marc_Germanic_Noblewomen_Archers	Germanic Noblewoman Archers	true
land_units_onscreen_name_inv_sam_polybolos	Samnite Polybolos	true
land_units_onscreen_name_inv_rom_polybolos	Roman Polybolos	true
land_units_onscreen_name_dk_num_desert_legionaries	Desert Legionaries	true
land_units_onscreen_name_inv_ins_longsword_warriors	Longsword Warriors	true
land_units_onscreen_name_inv_car_polybolos	Carthaginian Polybolos	true
land_units_onscreen_name_inv_etr_polybolos	Etruscan Polybolos	true
land_units_onscreen_name_inv_gre_polybolos	Greek Polybolos	true
land_units_onscreen_name_inv_iol_polybolos	Iolean Polybolos	true
land_units_onscreen_name_Ger_Spear_Brothers	Spear Brothers	true
land_units_onscreen_name_3c_Rom_Light_Roman_Skirmishers	Light Roman Skirmishers	true
land_units_onscreen_name_3c_Ala_Alani_Swordsmen	Alani Swordsmen	true
land_units_onscreen_name_3c_Sas_Zhayedan_Immortals_comm	Zhayedan Immortals Bodyguard	true
land_units_onscreen_name_3c_Sas_Sassanian_Levy_Spearmen	Sassanian Levy Spearmen	true
land_units_onscreen_name_3c_Cal_Caledonian_Spear_Wall	Caledonii Spear Wall	true
land_units_onscreen_name_inv_iol_noble_sardi_archers	Noble Sardi Archers	true
land_units_onscreen_name_Gre_Heroes_Sparta	Heroes of Sparta	true
land_units_onscreen_name_inv_app_swordsmen	Iapygian Swordsmen	true
land_units_onscreen_name_inv_tar_tarantine_peltasts	Tarantine Peltasts	true
land_units_onscreen_name_Aux_Cel_Light_Horse	Auxiliary Celtic Light Horse	true
land_units_onscreen_name_Aux_Scy_Armour_horse_Archers	Auxiliary Armoured Horse Archers	true
land_units_onscreen_name_3c_Mer_Celtic_Skirmishers	Mercenary Celtic Skirmishers	true
land_units_onscreen_name_3c_Cel_Celtic_Swordsmen_comm	Celtic Swordsmen Bodyguard	true
land_units_onscreen_name_3c_Bri_Large_Onager	Briton Heavy Onager	true
land_units_onscreen_name_inv_mercenary_gallic_axemen	Mercenary Gallic Axemen	true
land_units_onscreen_name_Bri_Heroic_Riders	Heroic Riders	true
land_units_onscreen_name_Pel_Light_Hoplites	Light Hoplites	true
land_units_onscreen_name_3c_Pal_Scythed_Chariots_comm	Scythed Chariots Bodyguard	true
land_units_onscreen_name_3c_Ger_Spear_Levy	Spear Levy	true
land_units_onscreen_name_3c_Pal_Armoured_Camels	Armoured Camels	true
land_units_onscreen_name_3c_Rom_Onager_Shp	Roman Onager (Ship)	true
land_units_onscreen_name_3c_Goth_Gothic_Warband	Gothic Warband	true
land_units_onscreen_name_Egy_Nubian_Bowmen	Nubian Bowmen	true
land_units_onscreen_name_Cel_Sword_Followers	Sword Followers	true
land_units_onscreen_name_Mer_Cel_Short_Swords	Mercenary Short Swords	true
land_units_onscreen_name_3c_Rom_Equites_Scutarii_comm	Equites Scutarii Bodyguard	true
land_units_onscreen_name_3c_Pal_Palmyrene_Spearmen_comm	Palmyrene Spearmen Bodyguard	true
land_units_onscreen_name_3c_Ala_Alani_Royal_Horses_comm	Alani Royal Horses Bodyguard	true
land_units_onscreen_name_3c_Mer_Gladiators	Mercenary Gladiators	true
land_units_onscreen_name_Thr_Nobles	Thracian Nobles	true
land_units_onscreen_name_3c_Ala_Noble_Steppe_Lancers	Noble Steppe Lancers	true
land_units_onscreen_name_inv_mercenary_etruscan_axe_infantry	Mercenary Etruscan Axe Infantry	true
land_units_onscreen_name_inv_sen_gallic_axe_cavalry	Gallic Axe Cavalry	true
land_units_onscreen_name_Egy_Karian_Axemen	Karian Axemen	true
land_units_onscreen_name_3c_Aux_Sarmatian_Horse_Archers	Auxiliary Sarmatian Horse Archers	true
land_units_onscreen_name_3c_Aux_Desert_Riders	Auxiliary Desert Riders	true
land_units_onscreen_name_Aux_Ger_Scout_Riders	Auxiliary Germanic Scout Riders	true
land_units_onscreen_name_3c_Ger_Noble_Germanic_Horsemen	Noble Germanic Horsemen	true
land_units_onscreen_name_Mer_Eas_Skirm_Cav	Mercenary Horse Skirmishers	true
land_units_onscreen_name_Gre_Foot_Companions	Foot Companions	true
land_units_onscreen_name_inv_sam_light_infantryman	Samnite Light Infantryman	true
land_units_onscreen_name_Aux_Bac_Light_Horse	Auxiliary Bactrian Light Horse	true
land_units_onscreen_name_inv_mercenary_carthaginian_peltasts	Mercenary Carthaginian Peltasts	true
land_units_onscreen_name_Aux_Gal_Light_Horse	Auxiliary Gallic Light Horse	true
land_units_onscreen_name_3c_Ste_Sarmatian_Horse_Archers	Sarmatian Horse Archers	true
land_units_onscreen_name_3c_Goth_Gothic_Pikemen	Gothic Pikemen	true
land_units_onscreen_name_3c_Per_Persian_Swordsmen	Persian Swordsmen	true
land_units_onscreen_name_3c_Mer_Sabean_Cavalry	Mercenary Sabean Cavalry	true
land_units_onscreen_name_Dac_Large_Onager	Dacian Heavy Onager	true
land_units_onscreen_name_Rom_Eagle_Cohort	Eagle Cohort	true
land_units_onscreen_name_3c_Ger_Giant_Ballista	German Giant Ballista	true
land_units_onscreen_name_dk_kush_armoured_shotel_warriors	Armoured Shotel Warriors	true
land_units_onscreen_name_dk_nab_desert_hoplites	Desert Hoplites	true
land_units_onscreen_name_dk_nab_nabatean_light_peltasts	Nabataean Light Peltasts	true
land_units_onscreen_name_dk_num_numidian_light_infantry	Numidian Light Infantry	true
land_units_onscreen_name_inv_iol_sardi_slingers	Sardi Slingers	true
land_units_onscreen_name_Car_Onager_Shp	Carthaginian Onager (Ship)	true
land_units_onscreen_name_Cel_Onager_Shp	Celtic Onager (Ship)	true
land_units_onscreen_name_3c_Mer_Iberian_Swordsmen	Mercenary Iberian Swordsmen	true
land_units_onscreen_name_3c_Ala_Steppe_Warband	Steppe Warband	true
land_units_onscreen_name_3c_Aux_Iberian_Swordsmen	Auxiliary Iberian Swordsmen	true
land_units_onscreen_name_3c_Sax_Gedriht_Swordsmen	Gedriht Swordsmen	true
land_units_onscreen_name_3c_Ger_Onager	German Onager	true
land_units_onscreen_name_inv_mercenary_ballista	Mercenary Ballista	true
land_units_onscreen_name_inv_iol_heavy_nuragic_runners	Heavy Nuragic Runners	true
land_units_onscreen_name_inv_african_elephants	African Elephants	true
land_units_onscreen_name_inv_mercenary_lucanian_veterans	Mercenary Lucanian Veterans	true
land_units_onscreen_name_dk_saba_marib_camel_cataphracts	Ma'rib Camel Cataphracts	true
land_units_onscreen_name_Bri_Onager_Shp	Briton Onager (Ship)	true
land_units_onscreen_name_3c_Aux_Camel_Spearmen	Auxiliary Camel Spearmen	true
land_units_onscreen_name_3c_Eas_Giant_Ballista	Eastern Giant Ballista	true
land_units_onscreen_name_3c_Eas_Noble_Spearmen	Noble Spearmen	true
land_units_onscreen_name_Cel_Heavy_Horse	Heavy Horse	true
land_units_onscreen_name_inv_gre_light_hoplites	Light Hoplites	true
land_units_onscreen_name_inv_sen_noble_swordsmen	Noble Gallic Swordsmen	true
land_units_onscreen_name_3c_Goth_Greuthungi_Elite_Spears	Greuthungi Elite Spears	true
land_units_onscreen_name_Aux_Gre_Tarantine_cav	Auxiliary Tarantine Cavalry	true
land_units_onscreen_name_Ger_Spearwomen	Spearwomen	true
land_units_onscreen_name_Mer_Gre_Tarantine_Cav	Mercenary Tarantine Cavalry	true
land_units_onscreen_name_Afr_Onager_Shp	African Onager (Ship)	true
land_units_onscreen_name_3c_Mer_Cretan_Archers	Mercenary Cretan Archers	true
land_units_onscreen_name_3c_Pal_Imperial_Palmyrene_Cataphracts_comm	Imperial Cataphracts Bodyguard	true
land_units_onscreen_name_3c_Eas_Onager	Eastern Onager	true
land_units_onscreen_name_3c_Arm_Noble_Horse_Archers	Noble Horse Archers	true
land_units_onscreen_name_inv_sam_light_spearmen	Samnite Light Spearmen	true
land_units_onscreen_name_Ara_Camel_Spear	Camel Spearmen	true
land_units_onscreen_name_Gre_Silver_Shield_Sword	Silver Shield Swordsmen	true
land_units_onscreen_name_3c_Ala_Alani_Noblewomen_Archers	Alani Noblewoman Archers	true
land_units_onscreen_name_inv_apulian_javelinmen	Native Iapygian Javelinmen	true
land_units_onscreen_name_Afr_Javelinmen	Javelinmen	true
land_units_onscreen_name_inv_mercenary_spartan_hoplites	Mercenary Spartan Hoplites	true
land_units_onscreen_name_3c_Bri_Onager	Briton Onager	true
land_units_onscreen_name_dk_kush_scythed_chariots	Scythed Chariots	true
land_units_onscreen_name_Mer_Ste_Amazonian_Riders	Mercenary 'Amazonian' Riders	true
land_units_onscreen_name_inv_iol_sardi_hillmen	Sardi Hillmen	true
land_units_onscreen_name_dk_mer_desert_cavalry	Mercenary Desert Cavalry	true
land_units_onscreen_name_dk_kush_kushite_slave_spearmen	Kushite Slave Spearmen	true
land_units_onscreen_name_inv_sen_gallic_axemen	Gallic Axemen	true
land_units_onscreen_name_Gre_Onager_Shp	Greek Onager (Ship)	true
land_units_onscreen_name_Ger_Onager_Shp	German Onager (Ship)	true
land_units_onscreen_name_3c_Cel_Celtic_Archers	Celtic Archers	true
land_units_onscreen_name_inv_ita_italic_swordsmen	Italian Swordsmen	true
land_units_onscreen_name_3c_Bri_Giant_Ballista	Briton Giant Ballista	true
land_units_onscreen_name_Ste_Scythian_Royal_Horse	Scythian Royal Horse	true
land_units_onscreen_name_3c_Cel_Celtic_Swordsmen	Celtic Swordsmen	true
land_units_onscreen_name_Eas_Bithynian_Infantry	Bithynian Infantry	true
land_units_onscreen_name_Gre_Javelinmen	Javelinmen	true
land_units_onscreen_name_inv_sabine_skirmishers	Native Sabine Skirmishers	true
land_units_onscreen_name_inv_ven_veneti_mounted_raiders	Veneti Mounted Raiders	true
land_units_onscreen_name_3c_Marc_Berserkers	Berserkers	true
land_units_onscreen_name_Ger_Scout_Riders	Germanic Scout Riders	true
land_units_onscreen_name_Gre_Large_Onager	Greek Heavy Onager	true
land_units_onscreen_name_Ibe_Large_Onager	Iberian Heavy Onager	true
land_units_onscreen_name_3c_Cal_Elite_Highland_Archers	Elite Highland Archers	true
land_units_onscreen_name_3c_Arm_Noble_Armenian_Archers_comm	Noble Armenian Archers Bodyguard	true
land_units_onscreen_name_3c_Afr_Giant_Ballista	African Giant Ballista	true
land_units_onscreen_name_Cel_Chosen_Spear	Chosen Spearmen	true
land_units_onscreen_name_Pel_Sakae_Horse_Archers	Sakae Horse Archers	true
land_units_onscreen_name_dk_afr_armoured_desert_cavalry	Armoured Desert Cavalry	true
land_units_onscreen_name_Eas_Onager_Shp	Eastern Onager (Ship)	true
land_units_onscreen_name_3c_Aux_Celtic_Archers	Auxiliary Celtic Archers	true
land_units_onscreen_name_3c_Afr_Onager	African Onager	true
land_units_onscreen_name_3c_Aux_Pontic_Cavalry	Auxiliary Pontic Cavalry	true
land_units_onscreen_name_dk_kush_leopard_warriors	Leopard Warriors	true
land_units_onscreen_name_dk_afr_desert_chariots	Desert Chariots	true
land_units_onscreen_name_inv_sen_noble_horsemen	Noble Horsemen	true
land_units_onscreen_name_Dac_Heavy_Skirm	Dacian Heavy Skirmishers	true
land_units_onscreen_name_inv_car_carthaginian_peltasts	Carthaginian Peltasts	true
land_units_onscreen_name_Eas_Javelinmen	Eastern Javelinmen	true
land_units_onscreen_name_Egy_Javelinmen	Egyptian Javelinmen	true
land_units_onscreen_name_Dac_Onager_Shp	Dacian Onager (Ship)	true
land_units_onscreen_name_inv_mercenary_ligurian_swordsmen	Mercenary Ligurian Swordsmen	true
land_units_onscreen_name_3c_Mer_Numidian_Javelinmen	Mercenary Numidian Javelinmen	true
land_units_onscreen_name_3c_Cal_Caledonian_Oathsworn_comm	Caledonii Oathsworn Bodyguard	true
land_units_onscreen_name_dk_kush_kushite_bowwomen	Kushite Archers	true
land_units_onscreen_name_Cel_Noble_Horse	Noble Horse	true
land_units_onscreen_name_3c_Ger_Armoured_Germanic_Swordsmen_comm	Armoured Germanic Swordsmen Bodyguard	true
land_units_onscreen_name_dk_afr_desert_cavalry	Desert Cavalry	true
land_units_onscreen_name_inv_mercenary_sicilian_slingers	Mercenary Sicilian Slingers	true
land_units_onscreen_name_3c_Sax_Noble_Saxon_Cavalry_comm	Noble Saxoni Cavalry Bodyguard	true
land_units_onscreen_name_Pel_Kilikian_Javelinmen	Kilikian Javelinmen	true
land_units_onscreen_name_inv_rom_roman_swordsmen	Roman Swordsmen	true
land_units_onscreen_name_inv_mercenary_nuragic_warriors	Mercenary Nuragic Warriors	true
land_units_onscreen_name_3c_Mer_African_Elephants	Mercenary African Elephants	true
land_units_onscreen_name_3c_Aux_African_Elephants	Auxiliary African Elephants	true
land_units_onscreen_name_3c_Afr_Onager_Bastion	African Bastion Onager	true
land_units_onscreen_name_dk_num_african_elephants	African Elephants	true
land_units_onscreen_name_dk_saba_sabaean_spearmen	Sabaean Spearmen	true
land_units_onscreen_name_Eas_Armour_Horse_Archers	Armoured Horse Archers	true
land_units_onscreen_name_Ste_Young_Axes	Young Axes	true
land_units_onscreen_name_inv_mercenary_balearic_slingers	Mercenary Balearic Slingers	true
land_units_onscreen_name_inv_etr_heavy_hoplites	Etruscan Heavy Hoplites	true
land_units_onscreen_name_inv_rom_eques	Eques	true
land_units_onscreen_name_inv_rom_leves	Leves	true
land_units_onscreen_name_Aux_Ara_Camel_Archers	Auxiliary Camel Archers	true
land_units_onscreen_name_Eas_Median_Cav	Median Cavalry	true
land_units_onscreen_name_Mer_Ara_Camel_Archers	Mercenary Camel Archers	true
land_units_onscreen_name_Rom_Armour_Legionaries	Armoured Legionaries	true
land_units_onscreen_name_3c_Sas_Gyan_Avspar	Gyan-Avspar	true
land_units_onscreen_name_Bri_Large_Onager	Briton Heavy Onager	true
land_units_onscreen_name_3c_Bri_Onager_Bastion	Briton Bastion Onager	true
land_units_onscreen_name_3c_Aux_Thracian_Heroic_Riders	Auxiliary Thracian Heroic Riders	true
land_units_onscreen_name_3c_Gal_Spear_Warriors	Spear Warriors	true
land_units_onscreen_name_3c_Arm_Noble_Armenian_Archers	Noble Armenian Archers	true
land_units_onscreen_name_3c_Marc_Horse_Runners	Horse Runners	true
land_units_onscreen_name_dk_kush_kushite_pikes	Kushite Pikes	true
land_units_onscreen_name_Bac_Light_Horse	Bactrian Light Horse	true
land_units_onscreen_name_inv_tribeless_warriors	Native Tribeless Warriors	true
land_units_onscreen_name_Mer_Ger_Wolf_Warriors	Mercenary Wolf Warriors	true
land_units_onscreen_name_inv_ill_nobles	Illyrian Nobles	true
land_units_onscreen_name_Ibe_Onager_Shp	Iberian Onager (Ship)	true
land_units_onscreen_name_Pel_Phoenician_Marines	Phoenician Marines	true
land_units_onscreen_name_Cel_Naked_Swords	Naked Swords	true
land_units_onscreen_name_3c_Mer_Pontic_Cavalry	Mercenary Pontic Cavalry	true
land_units_onscreen_name_3c_Cal_Scatha_Shadows	Scatha Shadows	true
land_units_onscreen_name_Ger_Noble_Riders	Noble Riders	true
land_units_onscreen_name_Eas_Pontic_Sword	Pontic Swordsmen	true
land_units_onscreen_name_Ger_Spear_Wall	Spear Wall	true
land_units_onscreen_name_inv_mercenary_samnite_veterans	Mercenary Samnite Veterans	true
land_units_onscreen_name_Pel_Thessalian_Hippeus	Thessalian Hippeus	true
land_units_onscreen_name_inv_rom_ensis_centuriae	Ensis Centuriae	true
land_units_onscreen_name_3c_Aux_Sabean_Cavalry	Auxiliary Sabaean Cavalry	true
land_units_onscreen_name_inv_rom_elite_equites	Elite Equites	true
land_units_onscreen_name_Bac_Noble_Horse	Bactrian Noble Horse	true
land_units_onscreen_name_Bri_Spear_Band	Spear Band	true
land_units_onscreen_name_Eas_Noble_Horse_Archers	Noble Horse Archers	true
land_units_onscreen_name_inv_mercenary_hoplites	Mercenary Hoplites	true
land_units_onscreen_name_inv_ill_slave_slingers	Slave Slingers	true
land_units_onscreen_name_Num_Javelinmen	Numidian Javelinmen	true
land_units_onscreen_name_dk_num_numidian_riders	Numidian Riders	true
land_units_onscreen_name_dk_num_desert_legionary_cavalry	Desert Legionary Cavalry	true
land_units_onscreen_name_Dac_Noble_Swords	Noble Swords	true
land_units_onscreen_name_3c_Eas_Onager_Bastion	Eastern Bastion Onager	true
land_units_onscreen_name_3c_Sab_Sabean_Archers	Sabean Archers	true
land_units_onscreen_name_Pel_Median_Spear	Median Spearmen	true
land_units_onscreen_name_Egy_Galatian_Royal_Guard	Galatian Royal Guard	true
land_units_onscreen_name_inv_ven_veneti_axemen	Veneti Axemen	true
land_units_onscreen_name_Bac_Royal_Guard	Bactrian Royal Guard	true
land_units_onscreen_name_Eas_Horse_Skirm	Horse Skirmishers	true
land_units_onscreen_name_3c_Goth_Tervingi_Oathsworn_comm	Tervingi Oathsworn Bodyguard	true
land_units_onscreen_name_Mer_Par_Spear	Mercenary Parthian Spearmen	true
land_units_onscreen_name_Aux_Par_Spear	Auxiliary Parthian Spearmen	true
land_units_onscreen_name_Mer_Afr_Spear	Mercenary Sabean Spearmen	true
land_units_onscreen_name_Mer_Ara_Spear	Mercenary Arabian Spearmen	true
land_units_onscreen_name_Mer_Ita_Spear	Mercenary Italian Spearmen	true
land_units_onscreen_name_Rom_Large_Onager	Roman Heavy Onager	true
land_units_onscreen_name_3c_Ala_Steppe_Cataphract_Archers_comm	Steppe Cataphract Archers Bodyguard	true
land_units_onscreen_name_3c_Mer_Camel_Spearmen	Mercenary Camel Spearmen	true
land_units_onscreen_name_Cel_Light_Horse	Light Horse	true
land_units_onscreen_name_Gre_Aspis_Companion_Cav	Aspis Companion Cavalry	true
land_units_onscreen_name_inv_syr_elite_hoplites	Elite Hoplites	true
land_units_onscreen_name_dk_saba_mer_marib_guard	Mercenary Ma'rib Guard	true
land_units_onscreen_name_3c_Ste_Steppe_Cavalry	Steppe Cavalry	true
land_units_onscreen_name_3c_Ger_Onager_Bastion	German Bastion Onager	true
land_units_onscreen_name_Cel_Large_Onager	Celtic Heavy Onager	true
land_units_onscreen_name_3c_Aux_Cretan_Archers	Auxiliary Cretan Archers	true
land_units_onscreen_name_3c_Rom_Cohors	Cohors	true
land_units_onscreen_name_Cel_Short_Swords	Short Swords	true
land_units_onscreen_name_inv_mercenary_aequi_swordsmen	Mercenary Aequi Swordsmen	true
land_units_onscreen_name_Rom_Gladiators	Gladiators	true
land_units_onscreen_name_dk_afr_slave_infantry	Slave Infantry	true
land_units_onscreen_name_Bri_Chosen_Spear_Band	Chosen Spear Band	true
land_units_onscreen_name_Eas_Large_Onager	Eastern Large Onager	true
land_units_onscreen_name_3c_Aux_Gallic_Cavalry	Auxiliary Gallic Cavalry	true
land_units_onscreen_name_3c_Ger_Germanic_Spear_Masters_comm	Germanic Spear Masters Bodyguard	true
land_units_onscreen_name_3c_Sas_Camel_Spearmen	Camel Spearmen	true
land_units_onscreen_name_dk_kush_kushite_slave_infantry	Kushite Slave Infantry	true
land_units_onscreen_name_inv_syr_giant_ballista	Giant Ballista	true
land_units_onscreen_name_3c_Ala_Noble_Steppe_Cataphracts	Noble Steppe Cataphracts	true
land_units_onscreen_name_Aux_Ita_Socii_Hastati	Socii Hastati	true
land_units_onscreen_name_3c_Ara_Arabian_Swordsmen	Arabian Swordsmen	true
land_units_onscreen_name_Afr_Large_Onager	African Heavy Onager	true
land_units_onscreen_name_Car_Large_Onager	Carthaginian Heavy Onager	true
land_units_onscreen_name_Ger_Large_Onager	German Heavy Onager	true
land_units_onscreen_name_3c_Mer_Steppe_Cavalry	Mercenary Steppe Cavalry	true
land_units_onscreen_name_3c_Cal_Chosen_Sword_Band	Chosen Sword Band	true
land_units_onscreen_name_3c_Cel_Chosen_Sword_Band	Chosen Sword Band	true
land_units_onscreen_name_3c_Marc_Night_Hunters	Night Hunters	true
land_units_onscreen_name_inv_sen_naked_warriors	Naked Warriors	true
land_units_onscreen_name_Ger_Spear_Levy	Spear Levy	true
land_units_onscreen_name_3c_Aux_Celtic_Swordsmen	Auxiliary Celtic Swordsmen	true
land_units_onscreen_name_inv_app_light_spearmen	Iapygian Light Spearmen	true
land_units_onscreen_name_3c_Cel_Celtic_Horse_Skirmishers	Celtic Horse Skirmishers	true
land_units_onscreen_name_3c_Aux_Gallic_Swordsmen	Auxiliary Gallic Swordsmen	true
land_units_onscreen_name_inv_ins_gallic_heavy_spearmen	Gallic Heavy Spearmen	true
land_units_onscreen_name_3c_Gal_Longsword_Cohort	Longsword Cohort 	true
land_units_onscreen_name_Aux_Ita_Socii_Equites	Socii Equites	true
land_units_onscreen_name_Rom_Onager_Shp	Roman Onager (Ship)	true
land_units_onscreen_name_3c_Num_Numidian_Noble_Cavalry_comm	Numidian Noble Cavalry Bodyguard	true
land_units_onscreen_name_inv_ven_veneti_outriders	Veneti Outriders	true
land_units_onscreen_name_3c_Ala_Alani_Horsemen	Alani Horsemen	true
land_units_onscreen_name_Ger_Bloodsworn	Bloodsworn	true
land_units_onscreen_name_inv_sen_gallic_hunters	Gallic Hunters	true
land_units_onscreen_name_3c_Arm_Noble_Horse_Archers_comm	Noble Horse Archers Bodyguard	true
land_units_onscreen_name_inv_iol_sardi_horse_skirmishers	Sardi Horse Skirmishers	true
land_units_onscreen_name_Pel_Javelinmen	Javelinmen	true
land_units_onscreen_name_3c_Sas_Eastern_Horse_Skirmishers	Eastern Horse Skirmishers	true
land_units_onscreen_name_3c_Mer_Syrian_Archers	Mercenary Syrian Archers	true
land_units_onscreen_name_3c_Mer_Sabean_Archers	Mercenary Sabean Archers	true
land_units_onscreen_name_3c_Eas_Eastern_Horse_Skirmishers	Eastern Horse Skirmishers	true
land_units_onscreen_name_Eas_Syrian_Heavy_Archers	Syrian Heavy Archers	true
land_units_onscreen_name_dk_num_gaetuli_horse_skirmishers	Gaetuli Horse Skirmishers	true
land_units_onscreen_name_3c_Pal_Camel_Spearmen	Camel Spearmen	true
land_units_onscreen_name_inv_sen_gallic_horse_skirmishers	Gallic Horse Skirmishers	true
land_units_onscreen_name_dk_ara_desert_chariots	Desert Chariots	true
land_units_onscreen_name_Ger_Berserkers	Berserkers	true
land_units_onscreen_name_3c_Aux_Persian_Horse_Skirmishers	Auxiliary Persian Horse Skirmishers	true
land_units_onscreen_name_3c_Per_Persian_Horse_Skirmishers	Persian Horse Skirmishers	true
land_units_onscreen_name_3c_Rom_Onager	Roman Onager	true
land_units_onscreen_name_3c_Sas_Grivpanvar_Cataphracts	Grivpanvar Cataphracts	true
land_units_onscreen_name_3c_Mer_Spear_Infantry	Mercenary Spear Infantry	true
land_units_onscreen_name_inv_gre_sicillian_skirmishers	Sicilian Peltasts	true
land_units_onscreen_name_3c_Gal_Gallic_Heavy_Skirmishers	Gallic Heavy Skirmishers	true
land_units_onscreen_name_Rom_First_Cohort	First Cohort	true
land_units_onscreen_name_3c_Pal_Hamian_Archers	Hamian Archers	true
land_units_onscreen_name_Cel_Chosen_Sword	Chosen Swordsmen	true
land_units_onscreen_name_3c_Pal_Palmyrene_Lanciarii	Palmyrene Lanciarii	true
land_units_onscreen_name_3c_Rom_Giant_Ballista	Roman Giant Ballista	true
land_units_onscreen_name_inv_etr_light_spearmen	Etruscan Light Spearmen	true
land_units_onscreen_name_3c_Ala_Steppe_Horse_Skirmishers	Steppe Horse Skirmishers	true
land_units_onscreen_name_inv_rom_ensis_principes	Ensis Principes	true
land_units_onscreen_name_3c_Cel_Celtic_Sword_Band	Celtic Sword Band	true
land_units_onscreen_name_inv_mercenary_campanian_cavalry	Mercenary Campanian Cavalry	true
land_units_onscreen_name_inv_rom_latin_tribesmen	Latin Tribesmen	true
land_units_onscreen_name_3c_Pal_Palmyrene_Legionary_Cavalry	Palmyrene Legionary Cavalry	true
land_units_onscreen_name_dk_num_gaetuli_tribesmen	Gaetuli Tribesmen	true
land_units_onscreen_name_inv_app_noble_hoplites	Iapygian Noble Hoplites	true
land_units_onscreen_name_inv_italian_swordsmen	Native Italian Swordsmen	true
land_units_onscreen_name_Gre_Silver_Shield_Pike	Silver Shield Pikemen	true
land_units_onscreen_name_Aux_Ill_Coastal_Levies	Auxiliary Coastal Levies	true
land_units_onscreen_name_Ste_Saka_Noble_Armour_Lancers	Saka Noble Armoured Lancers	true
land_units_onscreen_name_3c_Marc_Wolf_Warriors	Wolf Warriors	true
land_units_onscreen_name_3c_Aux_Numidian_Javelinmen	Auxiliary Numidian Javelinmen	true
land_units_onscreen_name_3c_Num_Numidian_Javelinmen	Numidian Javelinmen	true
land_units_onscreen_name_Dac_Heavy_Spears	Heavy Spears	true
land_units_onscreen_name_3c_Aux_Spear_Infantry	Auxiliary Spear Infantry	true
land_units_onscreen_name_3c_Gal_Gallic_Lanciarii	Gallic Lanciarii	true
land_units_onscreen_name_dk_ara_armoured_camel_spearmen	Armoured Camel Spearmen	true
land_units_onscreen_name_inv_rom_latin_spearmen	Latin Spearmen	true
land_units_onscreen_name_dk_nab_desert_pikemen	Desert Pikemen	true
land_units_onscreen_name_Ste_Horse_Skirm	Steppe Horse Skirmishers	true
land_units_onscreen_name_dk_num_desert_vigiles	Desert Vigiles	true
land_units_onscreen_name_inv_mercenary_ligurian_horsemen	Mercenary Ligurian Horsemen	true
land_units_onscreen_name_inv_local_gallic_axemen	Native Gallic Axemen	true
land_units_onscreen_name_Car_Snake_Pot_Ballista	Snake Pot Ballista	true
land_units_onscreen_name_inv_mercenary_sicilian_tribesmen	Mercenary Sicilian Tribesmen	true
land_units_onscreen_name_Cel_Spear_Nobles	Spear Nobles	true
land_units_onscreen_name_3c_Aux_Swordsmen_comm	Auxiliary Swordsmen Bodyguard	true
land_units_onscreen_name_3c_Arm_Noble_Armenian_Cavalry	Noble Armenian Cavalry	true
land_units_onscreen_name_Gre_Bronze_Shield_Pike	Bronze Shield Pikemen	true
land_units_onscreen_name_Ste_Royal_Horse_Archers	Royal Horse Archers	true
land_units_onscreen_name_Gre_Massilian_Hoplites	Massilian Hoplites	true
land_units_onscreen_name_Ste_Sarmatian_Horsemen	Sarmatian Horsemen	true
land_units_onscreen_name_Ste_Noble_Horse_Archers	Noble Horse Archers	true
land_units_onscreen_name_3c_Sab_Sabean_Armoured_Spearmen	Sabean Armoured Spearmen	true
land_units_onscreen_name_Bri_Chosen_Sword_Band	Chosen Sword Band	true
land_units_onscreen_name_3c_Pal_Palmyrene_Cohors	Palmyrene Cohors	true
land_units_onscreen_name_3c_Rom_Spear_Gladiators	Spear Gladiators	true
land_units_onscreen_name_3c_Rom_Onager_Bastion	Roman Bastion Onager	true
land_units_onscreen_name_Gre_Agema_Spears	Agema Spears	true
land_units_onscreen_name_3c_Goth_Greuthungi_Lancers	Greuthungi Lancers	true
land_units_onscreen_name_3c_Gal_Cohors	Cohors	true
land_units_onscreen_name_3c_Rom_Roman_Legionaries_comm	Roman Legionaries Bodyguard	true
land_units_onscreen_name_Mer_Pel_Agrianian_Axemen	Mercenary Agrianian Axemen	true
land_units_onscreen_name_3c_Pal_Heavy_Palmyrene_Skirmishers	Heavy Palmyrene Skirmishers	true
land_units_onscreen_name_Bri_Sword_Band	Sword Band	true
land_units_onscreen_name_3c_Sax_Duguth_Swordsmen	Duguth Swordsmen	true
land_units_onscreen_name_inv_mercenary_etruscan_hoplites	Mercenary Etruscan Hoplites	true
land_units_onscreen_name_3c_Gal_Gallic_Legionary_Cavalry	Gallic Legionary Cavalry	true
land_units_onscreen_name_Dac_Noble_Spears	Noble Spears	true
land_units_onscreen_name_3c_Ala_Steppe_Cataphract_Archers	Steppe Cataphract Archers	true
land_units_onscreen_name_inv_iol_sardi_spearmen	Sardi Spearmen	true
land_units_onscreen_name_inv_iol_sardi_cavalry	Sardi Cavalry	true
land_units_onscreen_name_3c_Mer_Gallic_Swordsmen	Mercenary Gallic Swordsmen	true
land_units_onscreen_name_dk_mer_nubian_spearmen	Mercenary Nubian Spearmen	true
land_units_onscreen_name_Mer_Gre_Thureos_Spears	Mercenary Thureos Spears	true
land_units_onscreen_name_Mer_Ill_Coastal_Levies	Mercenary Coastal Levies	true
land_units_onscreen_name_inv_ven_veneti_hunters	Veneti Hunters	true
land_units_onscreen_name_Cel_Mighty_Horse	Mighty Horse	true
land_units_onscreen_name_Gre_Thorax_Sword	Thorax Swordsmen	true
land_units_onscreen_name_Ste_Noblewomen	Scythian Noblewomen	true
land_units_onscreen_name_3c_Aux_Steppe_Cavalry	Auxiliary Steppe Cavalry	true
land_units_onscreen_name_Bri_Scout_Riders	Briton Scout Riders	true
land_units_onscreen_name_3c_Ala_Steppe_Lancers	Steppe Lancers	true
land_units_onscreen_name_Cel_Naked_Spears	Naked Spears	true
land_units_onscreen_name_3c_Ala_Steppe_Cavalry	Steppe Cavalry	true
land_units_onscreen_name_3c_Mer_Sabean_Javelinmen	Mercenary Sabean Javelinmen	true
land_units_onscreen_name_3c_Sab_Sabean_Javelinmen	Sabean Javelinmen	true
land_units_onscreen_name_dk_kush_slave_slingers	Slave Slingers	true
land_units_onscreen_name_3c_Sab_Sabean_Cavalry	Sabean Cavalry	true
land_units_onscreen_name_3c_Arm_Noble_Cataphracts_comm	Noble Cataphracts Bodyguard	true
land_units_onscreen_name_Dac_Heavy_Bowmen	Dacian Heavy Bowmen	true
land_units_onscreen_name_Egy_Nubian_Spear	Nubian Spearmen	true
land_units_onscreen_name_inv_car_sword_militia	Sword Militia	true
land_units_onscreen_name_3c_Rom_Praetorian_Guard	Praetorian Guard	true
land_units_onscreen_name_Eas_Noble_Spear	Noble Spearmen	true
land_units_onscreen_name_Ara_Noble_Sword	Noble Swordsmen	true
land_units_onscreen_name_3c_Cel_Celtic_Warhounds	Celtic Warhounds	true
land_units_onscreen_name_Gre_Royal_Guard	Hellenic Royal Guard	true
land_units_onscreen_name_Aux_Dac_Skirm	Auxiliary Dacian Skirmishers	true
land_units_onscreen_name_Aux_Cel_Skirm	Auxiliary Celtic Skirmishers	true
land_units_onscreen_name_Aux_Ibe_Sword	Auxiliary Iberian Swordsmen	true
land_units_onscreen_name_Mer_Cel_Skirm	Mercenary Celtic Skirmishers	true
land_units_onscreen_name_Mer_Ibe_Sword	Mercenary Iberian Swordsmen	true
land_units_onscreen_name_Mer_Ita_Sword	Mercenary Italian Swordsmen	true
land_units_onscreen_name_Mer_Dac_Skirm	Mercenary Dacian Skirmishers	true
land_units_onscreen_name_Gre_Gorgos_Skirmishers	Gorgo's Skirmishers	true
land_units_onscreen_name_Eas_Par_Sword	Parthian Swordsmen	true
land_units_onscreen_name_3c_Aux_Sabean_Archers	Auxiliary Sabaean Archers	true
land_units_onscreen_name_3c_Aux_Syrian_Archers	Auxiliary Syrian Archers	true
land_units_onscreen_name_Ste_Armour_Horse_Archers	Armoured Horse Archers	true
land_units_onscreen_name_3c_Sax_Noble_Saxon_Cavalry	Noble Saxoni Cavalry	true
land_units_onscreen_name_testtest_test	Alani 'Amazonian' Archers	true
land_units_onscreen_name_Aux_Par_Horse_Archers	Auxiliary Parthian Horse Archers	true
land_units_onscreen_name_Aux_Sar_Horse_Archers	Auxiliary Sarmatian Horse Archers	true
land_units_onscreen_name_Aux_Scy_Horse_Archers	Auxiliary Scythian Horse Archers	true
land_units_onscreen_name_Mer_Par_Horse_Archers	Mercenary Parthian Horse Archers	true
land_units_onscreen_name_Mer_Sar_Horse_Archers	Mercenary Sarmatian Horse Archers	true
land_units_onscreen_name_Mer_Scy_Horse_Archers	Mercenary Scythian Horse Archers	true
land_units_onscreen_name_Mer_Ita_Samnite_Warriors	Mercenary Samnite Warriors	true
land_units_onscreen_name_3c_Mer_Cappadocian_Cavalry	Mercenary Cappadocian Cavalry	true
land_units_onscreen_name_3c_Ger_Germanic_Spear_Masters	Germanic Spear Masters	true
land_units_onscreen_name_Afr_Skirm_Cav	Skirmisher Cavalry	true
land_units_onscreen_name_Gre_Skirm_Cav	Skirmisher Cavalry	true
land_units_onscreen_name_Ibe_Guerilla_Warriors	Guerrilla Warriors	true
land_units_onscreen_name_3c_Aux_Chariots	Auxiliary Chariots	true
land_units_onscreen_name_3c_Mer_Numidian_Cavalry	Mercenary Numidian Cavalry	true
land_units_onscreen_name_3c_Arm_Armenian_Pikemen	Armenian Pikemen	true
land_units_onscreen_name_Eas_Mob	Mob	true
land_units_onscreen_name_Car_Mob	Mob	true
land_units_onscreen_name_3c_Pal_Hamian_Archers_comm	Hamian Archers Bodyguard	true
land_units_onscreen_name_inv_mercenary_massilian_hoplites	Mercenary Massilian Hoplites	true
land_units_onscreen_name_inv_ill_spearmen	Illyrian Spearmen	true
land_units_onscreen_name_Ara_Levy_Skirm	Levy Skirmishers	true
land_units_onscreen_name_Gre_Levy_Pike	Levy Pikemen	true
land_units_onscreen_name_3c_Ger_Germanic_Mounted_Warband	Germanic Mounted Warband	true
land_units_onscreen_name_3c_Mer_Germanic_Mounted_Warband	Mercenary Germanic Mounted Warband	true
land_units_onscreen_name_3c_Mer_Illyrian_Raiders	Mercenary Illyrian Raiders	true
land_units_onscreen_name_3c_Aux_Egyptian_Pikemen	Auxiliary Egyptian Pikemen	true
land_units_onscreen_name_3c_Eas_Eastern_Nobles	Eastern Nobles	true
land_units_onscreen_name_Bri_Ballista_Shp	Briton Ballista (Ship)	true
land_units_onscreen_name_3c_Ger_Germanic_Horsemen	Germanic Horsemen	true
land_units_onscreen_name_Ibe_Lusitani_Swordswomen	Lusitani Swordswomen	true
land_units_onscreen_name_3c_Ara_Arabian_Nobles_comm	Arabian Nobles Bodyguard	true
land_units_onscreen_name_3c_Per_Persian_Nobles_comm	Persian Nobles Bodyguard	true
land_units_onscreen_name_3c_Sas_Persian_Spearmen	Persian Spearmen	true
land_units_onscreen_name_inv_mercenary_velites	Mercenary Velites	true
land_units_onscreen_name_Mer_Gal_Gallic_Hunters	Mercenary Gallic Hunters	true
land_units_onscreen_name_Ibe_Scutarii_Cav	Scutarii Cavalry	true
land_units_onscreen_name_3c_Per_Persian_Skirmishers	Persian Skirmishers	true
land_units_onscreen_name_3c_Eas_Eastern_Axe_Warriors_comm	Eastern Axe Warriors Bodyguard	true
land_units_onscreen_name_inv_ill_slave_javelinmen	Slave Javelinmen	true
land_units_onscreen_name_inv_mercenary_sileraioi_hoplites	Mercenary Sileraioi Hoplites	true
land_units_onscreen_name_Mer_Thr_Peltasts	Mercenary Thracian Peltasts	true
land_units_onscreen_name_3c_Sas_Camel_Cataphracts	Camel Cataphracts	true
land_units_onscreen_name_3c_Per_Persian_Spearmen	Persian Spearmen	true
land_units_onscreen_name_inv_ita_italic_spearmen	Italian Spearmen	true
land_units_onscreen_name_3c_Eas_Eastern_Spearmen	Eastern Spearmen	true
land_units_onscreen_name_3c_Ara_Arabian_Spearmen	Arabian Spearmen	true
land_units_onscreen_name_Aux_Dac_Bowmen	Auxiliary Dacian Bowmen	true
land_units_onscreen_name_inv_app_cavalry	Iapygian Cavalry	true
land_units_onscreen_name_3c_Ger_Germanic_Hurlers	Germanic Hurlers	true
land_units_onscreen_name_Pel_Thr_Archers	Thraike Archers	true
land_units_onscreen_name_3c_Ger_Germanic_Hunters	Germanic Hunters	true
land_units_onscreen_name_3c_Mer_Germanic_Hunters	Mercenary Germanic Hunters	true
land_units_onscreen_name_Mer_Kushite_Shieldwomen	Mercenary Kushite Shieldwomen	true
land_units_onscreen_name_Ill_Cav	Illyrian Cavalry	true
land_units_onscreen_name_inv_mercenary_brutti_veterans	Mercenary Brutti Veterans	true
land_units_onscreen_name_Afr_Numidian_Cav	Numidian Cavalry	true
land_units_onscreen_name_inv_etr_slingers	Etruscan Slingers	true
land_units_onscreen_name_3c_Sax_Elite_Saxon_Javelinmen	Elite Saxoni Javelinmen	true
land_units_onscreen_name_inv_local_naked_warriors	Naked Native Warriors	true
land_units_onscreen_name_3c_Pal_Armoured_Horse_Archers	Armoured Horse Archers	true
land_units_onscreen_name_dk_num_armoured_desert_chariots	Armoured Desert Chariots	true
land_units_onscreen_name_Car_Sacred_Band	Sacred Band	true
land_units_onscreen_name_Cel_Guerilla_Swordsmen	Guerrilla Swordsmen	true
land_units_onscreen_name_Aux_Ill_Raiders	Auxiliary Illyrian Raiders	true
land_units_onscreen_name_3c_Aux_Alae_Skirmishers	Alae Skirmishers	true
land_units_onscreen_name_3c_Mer_Slingers	Mercenary Slingers	true
land_units_onscreen_name_3c_Bri_Scorpion	Briton Scorpion (Fixed)	true
land_units_onscreen_name_inv_gre_militia_spearmen	Militia Spearmen	true
land_units_onscreen_name_3c_Gal_Armoured_Chariots	Armoured Chariots	true
land_units_onscreen_name_3c_Cal_Armoured_Chariots	Armoured Chariots	true
land_units_onscreen_name_3c_Aux_Armoured_Chariots	Auxiliary Armored Chariots	true
land_units_onscreen_name_3c_Sax_Gedriht_Swordsmen_comm	Gedriht Swordsmen Bodyguard	true
land_units_onscreen_name_inv_app_peltasts	Iapygian Peltasts	true
land_units_onscreen_name_Mer_Cel_Warriors	Mercenary Celtic Warriors	true
land_units_onscreen_name_Mer_Gal_Warriors	Mercenary Gallic Warriors	true
land_units_onscreen_name_Pel_Thr_Warriors	Thraike Warriors	true
land_units_onscreen_name_3c_Goth_Tervingi_Oathsworn	Tervingi Oathsworn	true
land_units_onscreen_name_3c_Sax_Gedriht_Spearmen	Gedriht Spearmen	true
land_units_onscreen_name_3c_Mer_Rhodian_Slingers	Mercenary Rhodian Slingers	true
land_units_onscreen_name_Ibe_Vet_Shield_Warriors	Veteran Shield Warriors	true
land_units_onscreen_name_Rom_Polybolos	Roman Polybolos	true
land_units_onscreen_name_3c_Aux_Iberian_Slingers	Auxiliary Iberian Slingers	true
land_units_onscreen_name_Ibe_Scut_Spear	Scutarii Spearmen	true
land_units_onscreen_name_Car_Polybolos	Carthaginian Polybolos	true
land_units_onscreen_name_Gre_Polybolos	Greek Polybolos	true
land_units_onscreen_name_Aux_Dac_Spears	Auxiliary Dacian Spears	true
land_units_onscreen_name_3c_Ger_Test_Mis	Test Missile 	true
land_units_onscreen_name_3c_Pal_Armoured_Pikemen	Armoured Pikemen	true
land_units_onscreen_name_inv_italian_skirmishers	Native Italian Skirmishers	true
land_units_onscreen_name_Aux_Gre_Cretan_Archers	Auxiliary Cretan Archers	true
land_units_onscreen_name_3c_Rom_Balearic_Slingers	Balearic Slingers	true
land_units_onscreen_name_Rom_Gladiatrices	Gladiatrices	true
land_units_onscreen_name_Gre_Hellenic_Cataphracts	Hellenic Cataphracts	true
land_units_onscreen_name_Rom_Ballista_Shp	Roman Ballista (Ship)	true
land_units_onscreen_name_3c_Mer_Balearic_Slingers	Mercenary Balearic Slingers	true
land_units_onscreen_name_3c_Goth_Greuthungi_Noble_Cavalry_comm	Greuthungi Noble Cavalry Bodyguard	true
land_units_onscreen_name_3c_Aux_Germanic_Spear_Masters	Auxiliary Germanic Spear Masters	true
land_units_onscreen_name_3c_Pal_Imperial_Palmyrene_Cataphracts	Imperial Palmyrene Cataphracts	true
land_units_onscreen_name_Mer_Eas_Hillmen	Mercenary Hillmen	true
land_units_onscreen_name_Gre_Periokoi_Hoplites	Perioikoi Hoplites	true
land_units_onscreen_name_3c_Eas_Ballista	Eastern Ballista	true
land_units_onscreen_name_Mer_Bac_Hillmen	Mercenary Bactrian Hillmen	true
land_units_onscreen_name_Pel_Periokoi_Hoplites	Perioikoi Hoplites	true
land_units_onscreen_name_Egy_Mob	Mob	true
land_units_onscreen_name_inv_mercenary_african_elephants	Mercenary African Elephants	true
land_units_onscreen_name_3c_Num_Numidian_Slingers_comm	Numidian Slingers Bodyguard	true
land_units_onscreen_name_3c_Num_Numidian_Slingers	Numidian Slingers	true
land_units_onscreen_name_3c_Sas_Persian_Skirmishers	Persian Skirmishers	true
land_units_onscreen_name_inv_local_gallic_hunters	Native Gallic Hunters	true
land_units_onscreen_name_Cel_Ballista_Shp	Celtic Ballista (Ship)	true
land_units_onscreen_name_3c_Cel_Celtic_Levy	Celtic Levy	true
land_units_onscreen_name_inv_car_ballista	Carthaginian Ballista	true
land_units_onscreen_name_inv_etr_ballista	Etruscan Ballista	true
land_units_onscreen_name_dk_saba_sabaean_archers	Sabaean Archers	true
land_units_onscreen_name_inv_sen_gallic_spearmen	Gallic Spearmen	true
land_units_onscreen_name_Gre_Thorax_Pike	Thorax Pikemen	true
land_units_onscreen_name_Ste_Scythian_Royal_Skirmishers	Scythian Royal Skirmishers	true
land_units_onscreen_name_3c_Mer_Peltasts	Mercenary Peltasts	true
land_units_onscreen_name_Thr_Cav	Thracian Cavalry	true
land_units_onscreen_name_Mer_Ibe_Cantabrian_Cav	Mercenary Cantabrian Cavalry	true
land_units_onscreen_name_3c_Mer_Egyptian_Archers	Mercenary Egyptian Archers	true
land_units_onscreen_name_3c_Afr_Ballista	African Ballista	true
land_units_onscreen_name_3c_Ger_Ballista	German Ballista	true
land_units_onscreen_name_Ger_Club_Levy	Club Levy	true
land_units_onscreen_name_Pel_Thr_Marines	Thraike Marines	true
land_units_onscreen_name_3c_Cal_Armoured_Chariots_comm	Armoured Chariots Bodyguard	true
land_units_onscreen_name_3c_Mer_Illyrian_Armoured_Pikemen	Mercenary Illyrian Armoured Pikemen	true
land_units_onscreen_name_3c_Mer_Numidian_Infantry	Mercenary Numidian Infantry	true
land_units_onscreen_name_3c_Cel_Chosen_Sword_Band_comm	Chosen Sword Band Bodyguard	true
land_units_onscreen_name_Dac_Ballista_Shp	Dacian Ballista (Ship)	true
land_units_onscreen_name_3c_Num_Numidian_Infantry	Numidian Infantry	true
land_units_onscreen_name_3c_Aux_Numidian_Infantry	Auxiliary Numidian Infantry	true
land_units_onscreen_name_3c_Aux_Illyrian_Armoured_Pikemen	Auxiliary Illyrian Armoured Pikemen	true
land_units_onscreen_name_3c_Num_Numidian_Noble_Cavalry	Numidian Noble Cavalry	true
land_units_onscreen_name_inv_app_hoplites	Iapygian Hoplites	true
land_units_onscreen_name_3c_Aux_Eastern_Spearmen	Auxiliary Eastern Spearmen	true
land_units_onscreen_name_inv_mercenary_toxotes	Mercenary Toxotes	true
land_units_onscreen_name_Cel_Savage_Dogs	Savage Dogs	true
land_units_onscreen_name_Egy_Cav	Egyptian Cavalry	true
land_units_onscreen_name_3c_Eas_Ballista_Bastion	Eastern Bastion Ballista	true
land_units_onscreen_name_Mer_Pel_Ionian_Hippeus	Mercenary Ionian Hippeus	true
land_units_onscreen_name_inv_etruscan_spearmen	Native Etruscan Spearmen	true
land_units_onscreen_name_3c_Rom_Armoured_Archers	Armoured Archers	true
land_units_onscreen_name_3c_Cal_Highland_Archers	Highland Archers	true
land_units_onscreen_name_Egy_Pike	Egyptian Pikemen	true
land_units_onscreen_name_3c_Rom_Evocati_Cohort_comm	Evocati Cohort Bodyguard	true
land_units_onscreen_name_3c_Per_Persian_Light_Infantry	Persian Light Infantry	true
land_units_onscreen_name_Aux_Thr_Peltasts	Auxiliary Thracian Peltasts	true
land_units_onscreen_name_3c_Aux_Persian_Spearmen	Auxiliary Persian Spearmen	true
land_units_onscreen_name_inv_ven_veneti_spearmen	Veneti Spearmen	true
land_units_onscreen_name_Cel_Oathsworn	Oathsworn	true
land_units_onscreen_name_3c_Pal_Scythed_Chariots	Scythed Chariots	true
land_units_onscreen_name_Ita_Levy_Skirm	Levy Skirmishers	true
land_units_onscreen_name_3c_Goth_Gothic_Mounted_Brigands	Gothic Mounted Brigands	true
land_units_onscreen_name_inv_rom_rorarii	Rorarii	true
land_units_onscreen_name_Mer_Ger_Longbow_Hunters	Mercenary Longbow Hunters	true
land_units_onscreen_name_Mer_Gre_Cretan_Archers	Mercenary Cretan Archers	true
land_units_onscreen_name_3c_Aux_Germanic_Hunters	Auxiliary Germanic Hunters	true
land_units_onscreen_name_Mer_Dac_Spears	Mercenary Dacian Spears	true
land_units_onscreen_name_3c_Afr_Ballista_Bastion	African Bastion Ballista	true
land_units_onscreen_name_3c_Ger_Ballista_Bastion	German Bastion Ballista	true
land_units_onscreen_name_Aux_Sar_Lancers	Auxiliary Sarmatian Lancers	true
land_units_onscreen_name_Gre_Levy_Thureos_Spears	Levy Thureos Spears	true
land_units_onscreen_name_3c_Aux_Scutarii	Auxiliary Scutarii	true
land_units_onscreen_name_3c_Sas_Persian_Light_Infantry	Persian Light Infantry	true
land_units_onscreen_name_3c_Arm_Noble_Cataphracts	Noble Cataphracts	true
land_units_onscreen_name_inv_car_hoplites	Carthaginian Hoplites	true
land_units_onscreen_name_inv_etr_hoplites	Etruscan Hoplites	true
land_units_onscreen_name_inv_etr_chariots	Etruscan Chariots	true
land_units_onscreen_name_3c_Ara_Arabian_Camel_Spearmen	Arabian Camel Spearmen	true
land_units_onscreen_name_3c_Aux_Arabian_Camel_Spearmen	Auxiliary Arabian Camel Spearmen	true
land_units_onscreen_name_Rom_Gladiatrices_Spear	Spear Gladiatrices	true
land_units_onscreen_name_Aet_Cav	Aethiopian Cavalry	true
land_units_onscreen_name_3c_Bri_Scorpion_Bastion	Briton Bastion Scorpion	true
land_units_onscreen_name_3c_Aux_Numidian_Cavalry	Auxiliary Numidian Cavalry	true
land_units_onscreen_name_3c_Aux_Germanic_Falxmen	Auxiliary Germanic Falxmen	true
land_units_onscreen_name_inv_mercenary_thessalian_cavalry	Mercenary Thessalian Cavalry	true
land_units_onscreen_name_3c_Arm_Armenian_Slingers	Armenian Slingers	true
land_units_onscreen_name_3c_Rom_Evocati_Cohort	Evocati Cohort	true
land_units_onscreen_name_inv_car_Infantry	Carthaginian Infantry	true
land_units_onscreen_name_Gre_Polybolos_Bastion	Greek Bastion Polybolos	true
land_units_onscreen_name_Car_Polybolos_Bastion	Carthaginian Bastion Polybolos	true
land_units_onscreen_name_Eas_Camel_Cataphracts	Camel Cataphracts	true
land_units_onscreen_name_Rom_Polybolos_Bastion	Roman Bastion Polybolos	true
land_units_onscreen_name_dk_nab_armoured_desert_hoplites	Armoured Desert Hoplites	true
land_units_onscreen_name_inv_ins_gallic_elder_swordsmen	Gallic Elder Swordsmen	true
land_units_onscreen_name_3c_Aux_Illyrian_Raiders	Auxiliary Illyrian Raiders	true
land_units_onscreen_name_3c_Mer_Egyptian_Pikemen	Mercenary Egyptian Pikemen	true
land_units_onscreen_name_Gre_Periokoi_Peltasts	Perioikoi Peltasts	true
land_units_onscreen_name_Aux_Ibe_Cantabrian_Cav	Auxiliary Cantabrian Cavalry	true
land_units_onscreen_name_3c_Aux_Illyrian_Cavalry	Auxiliary Illyrian Cavalry	true
land_units_onscreen_name_3c_Gal_Armoured_Chariots_comm	Armoured Chariots Bodyguard	true
land_units_onscreen_name_3c_Sas_Immortal_Infantry	Immortal Infantry	true
land_units_onscreen_name_3c_Mer_Swordsmen	Mercenary Swordsmen	true
land_units_onscreen_name_3c_Aux_Swordsmen	Auxiliary Swordsmen	true
land_units_onscreen_name_3c_Cel_Painted_Warriors	Painted Warriors	true
land_units_onscreen_name_3c_Arm_Armenian_Archers	Armenian Archers	true
land_units_onscreen_name_Mer_Egy_Archers	Mercenary Egyptian Archers	true
land_units_onscreen_name_3c_Rom_Polybolos	Roman Polybolos	true
land_units_onscreen_name_3c_Aux_Peltasts	Auxiliary Peltasts	true
land_units_onscreen_name_3c_Aux_Egyptian_Archers	Auxiliary Egyptian Archers	true
land_units_onscreen_name_Ibe_Cav	Iberian Cavalry	true
land_units_onscreen_name_inv_car_citizen_militia	Citizen Militia	true
land_units_onscreen_name_Mer_Afr_Archers	Mercenary Sabean Archers	true
land_units_onscreen_name_inv_mercenary_italic_skirmishers	Mercenary Italian Skirmishers	true
land_units_onscreen_name_3c_Sas_Immortal_Infantry_comm	Immortal Infantry Bodyguard	true
land_units_onscreen_name_3c_Sas_Savaran_Cataphracts	Savaran Cataphracts	true
land_units_onscreen_name_3c_Mer_Persian_Cataphracts	Mercenary Persian Cataphracts	true
land_units_onscreen_name_3c_Per_Persian_Cataphracts	Persian Cataphracts	true
land_units_onscreen_name_Gre_Ballista_Shp	Greek Ballista (Ship)	true
land_units_onscreen_name_Ibe_Ballista_Shp	Iberian Ballista (Ship)	true
land_units_onscreen_name_3c_Ara_Arabian_Nobles	Arabian Nobles	true
land_units_onscreen_name_3c_Per_Persian_Nobles	Persian Nobles	true
land_units_onscreen_name_3c_Eas_Eastern_Bowmen	Eastern Bowmen	true
land_units_onscreen_name_Aux_Egy_Infantry	Auxiliary Egyptian Infantry	true
land_units_onscreen_name_3c_Goth_Gothic_Slingers	Gothic Slingers	true
land_units_onscreen_name_3c_Rom_Scorpion_Bastion	Roman Bastion Scorpion	true
land_units_onscreen_name_inv_mercenary_umbrian_defenders	Mercenary Umbrian Defenders	true
land_units_onscreen_name_Car_Cav	Carthaginian Cavalry	true
land_units_onscreen_name_Pel_Thr_Nobles	Thraike Nobles	true
land_units_onscreen_name_inv_samnite_infantryman	Native Samnite Infantryman	true
land_units_onscreen_name_Mer_Dac_Falxmen	Mercenary Falxmen	true
land_units_onscreen_name_Ibe_Balearic_Slingers	Balearic Slingers	true
land_units_onscreen_name_Mer_Per_Archers	Mercenary Persian Archers	true
land_units_onscreen_name_inv_gre_hippeus	Hippeus	true
land_units_onscreen_name_3c_Sax_Germanic_Archers	Germanic Archers	true
land_units_onscreen_name_Aux_Gal_Gallic_Hunters	Auxiliary Gallic Hunters	true
land_units_onscreen_name_3c_Aux_Thracian_Slingers	Auxiliary Thracian Slingers	true
land_units_onscreen_name_3c_Mer_Thracian_Slingers	Mercenary Thracian Slingers	true
land_units_onscreen_name_dk_num_armoured_numidian_cavalry	Armoured Numidian Cavalry	true
land_units_onscreen_name_Car_Late_Libyan_Hoplites	Late Libyan Hoplites	true
land_units_onscreen_name_Aux_Cel_Warriors	Auxiliary Celtic Warriors	true
land_units_onscreen_name_Aux_Gal_Warriors	Auxiliary Gallic Warriors	true
land_units_onscreen_name_3c_Aux_Rhodian_Slingers	Auxiliary Rhodian Slingers	true
land_units_onscreen_name_dk_nab_scythed_chariots	Scythed Chariots	true
land_units_onscreen_name_3c_Mer_Iberian_Slingers	Mercenary Iberian Slingers	true
land_units_onscreen_name_3c_Sas_Hamspah_Infantry	Hamspah Infantry	true
land_units_onscreen_name_Eas_Royal_Cataphracts	Royal Cataphracts	true
land_units_onscreen_name_Gre_Sarissa_Cav	Sarissa Cavalry	true
land_units_onscreen_name_Mer_Eas_Cappadocian_Cav	Mercenary Cappadocian Cavalry	true
land_units_onscreen_name_inv_rom_velites	Velites	true
land_units_onscreen_name_inv_sicilian_tribesmen	Native Sicilian Tribesmen	true
land_units_onscreen_name_Mer_Dac_Bowmen	Mercenary Dacian Bowmen	true
land_units_onscreen_name_Rom_Legionaries	Legionaries	true
land_units_onscreen_name_3c_Pal_Palmyrene_Palace_Guard_comm	Palmyrene Palace Guard Bodyguard	true
land_units_onscreen_name_3c_Arm_Armenian_Spearmen	Armenian Spearmen	true
land_units_onscreen_name_inv_iol_nuragic_warriors	Nuragic Warriors	true
land_units_onscreen_name_3c_Arm_Armoured_Armenian_Pikemen	Armoured Armenian Pikemen	true
land_units_onscreen_name_3c_Aux_Cappadocian_Cavalry	Auxiliary Cappadocian Cavalry	true
land_units_onscreen_name_inv_ins_highland_hunters	Highland Hunters	true
land_units_onscreen_name_3c_Sas_Daylamite_Cavalry	Daylamite Cavalry	true
land_units_onscreen_name_Mer_Ibe_Scutarii	Mercenary Scutarii	true
land_units_onscreen_name_3c_Arm_Armoured_Armenian_Archers_comm	Armoured Armenian Archers Bodyguard	true
land_units_onscreen_name_inv_gre_ballista	Greek Ballista	true
land_units_onscreen_name_3c_Mer_Arabian_Spearmen	Mercenary Arabian Spearmen	true
land_units_onscreen_name_inv_sen_gallic_horsemen	Gallic Horsemen	true
land_units_onscreen_name_3c_Eas_Scorpion_Bastion	Eastern Bastion Scorpion	true
land_units_onscreen_name_Pel_Immortal_Spearmen	Immortal Spearmen	true
land_units_onscreen_name_3c_Ste_Ballista	Steppe Ballista	true
land_units_onscreen_name_3c_Mer_Scutarii_Cavalry	Mercenary Scutarii Cavalry	true
land_units_onscreen_name_inv_app_archers	Iapygian Archers	true
land_units_onscreen_name_inv_mercenary_italian_swordsmen	Mercenary Italian Swordsmen	true
land_units_onscreen_name_3c_Aux_Egyptian_Infantry	Auxiliary Egyptian Infantry	true
land_units_onscreen_name_3c_Pal_Palmyrene_Palace_Guard	Palmyrene Palace Guard	true
land_units_onscreen_name_3c_Mer_Egyptian_Infantry	Mercenary Egyptian Infantry	true
land_units_onscreen_name_Aux_Bri_Slingers	Auxiliary Briton Slingers	true
land_units_onscreen_name_3c_Aux_Bactrian_Horse_Archers	Auxiliary Bactrian Horse Archers	true
land_units_onscreen_name_3c_Eas_Eastern_Nobles_comm	Eastern Nobles Bodyguard	true
land_units_onscreen_name_3c_Sas_Armoured_Camel_Archers	Armoured Camel Archers	true
land_units_onscreen_name_3c_Mer_Lanciarii	Mercenary Lanciarii	true
land_units_onscreen_name_Aux_Thr_Warriors	Auxiliary Thracian Warriors	true
land_units_onscreen_name_3c_Aux_Lanciarii	Auxiliary Lanciarii	true
land_units_onscreen_name_3c_Ara_Arabian_Swordsmen_comm	Arabian Swordsmen Bodyguard	true
land_units_onscreen_name_3c_Per_Persian_Swordsmen_comm	Persian Swordsmen Bodyguard	true
land_units_onscreen_name_Ita_Campanian_Cavalry	Campanian Cavalry	true
land_units_onscreen_name_dk_nab_nabatean_heavy_archers	Nabataean Heavy Archers	true
land_units_onscreen_name_3c_Afr_Scorpion_Bastion	African Bastion Scorpion	true
land_units_onscreen_name_3c_Ger_Scorpion_Bastion	German Bastion Scorpion	true
land_units_onscreen_name_Gre_Citizen_Cav	Citizen Cavalry	true
land_units_onscreen_name_3c_Aux_Armoured_Pikemen	Auxiliary Armoured Pikemen	true
land_units_onscreen_name_3c_Rom_Balearic_Slingers_comm	Balearic Slingers Bodyguard	true
land_units_onscreen_name_Cel_Axe_Warriors	Axe Warriors	true
land_units_onscreen_name_3c_Mer_Thracian_Light_Cavalry	Mercenary Thracian Light Cavalry	true
land_units_onscreen_name_Ara_Levy_Spear	Levy Spearmen	true
land_units_onscreen_name_inv_mercenary_iberian_cavalry	Mercenary Iberian Cavalry	true
land_units_onscreen_name_Aux_Dac_Spear_Horsemen	Auxiliary Spear Horsemen	true
land_units_onscreen_name_3c_Mer_Painted_Warriors	Mercenary Painted Warriors	true
land_units_onscreen_name_3c_Sax_Geoguth_Spearmen	Geoguth Spearmen	true
land_units_onscreen_name_Afr_Levy_Spear	Levy Spearmen	true
land_units_onscreen_name_3c_Sax_Geoguth_Warriors	Geoguth Warriors	true
land_units_onscreen_name_3c_Mer_Illyrian_Archers	Mercenary Illyrian Archers	true
land_units_onscreen_name_Eas_Cataphracts	Eastern Cataphracts	true
land_units_onscreen_name_dk_kush_shotel_warriors	Shotel Warriors	true
land_units_onscreen_name_inv_lucanian_ambushers	Native Lucanian Ambushers	true
land_units_onscreen_name_Rom_Praetorians	Praetorians	true
land_units_onscreen_name_3c_Bri_Ballista_Bastion	Briton Bastion Ballista	true
land_units_onscreen_name_inv_ita_italian_cavalry	Italian Cavalry	true
land_units_onscreen_name_Eas_Azat_Knights	Azat Knights	true
land_units_onscreen_name_inv_mercenary_sabine_skirmishers	Mercenary Sabine Skirmishers	true
land_units_onscreen_name_3c_Aux_Persian_Skirmishers	Auxiliary Persian Skirmishers	true
land_units_onscreen_name_inv_gre_slingers	Greek Slingers	true
land_units_onscreen_name_Aux_Gre_Hoplites	Auxiliary Hoplites	true
land_units_onscreen_name_Thr_Royal_Cav	Thracian Royal Cavalry	true
land_units_onscreen_name_inv_ven_noble_veneti_swordsmen	Noble Veneti Swordsmen	true
land_units_onscreen_name_Bac_Royal_Cav	Bactrian Royal Cavalry	true
land_units_onscreen_name_3c_Cal_Caledonian_Heroic_Riders	Caledonii Heroic Riders	true
land_units_onscreen_name_Gre_Royal_Cav	Hellenic Royal Cavalry	true
land_units_onscreen_name_Gre_Mob	Mob	true
land_units_onscreen_name_3c_Mer_Thracian_Warriors	Mercenary Thracian Warriors	true
land_units_onscreen_name_Cel_Galatian_Legionaires	Galatian Legionaries	true
land_units_onscreen_name_inv_sam_italian_slingers	Italian Slingers	true
land_units_onscreen_name_3c_Aux_Thracian_Warriors	Auxiliary Thracian Warriors	true
land_units_onscreen_name_3c_Mer_Persian_Light_Infantry	Mercenary Persian Light Infantry	true
land_units_onscreen_name_inv_ill_hoplites	Illyrian Hoplites	true
land_units_onscreen_name_3c_Rom_Roman_Legionaries	Roman Legionaries	true
land_units_onscreen_name_Mer_Gre_Peltasts	Mercenary Peltasts	true
land_units_onscreen_name_3c_Ger_Savage_Dogs	Savage Dogs	true
land_units_onscreen_name_Ger_Tribesmen	Germanic Tribesmen	true
land_units_onscreen_name_Dac_Tribesmen	Dacian Tribesmen	true
land_units_onscreen_name_Cel_Tribesmen	Celtic Tribesmen	true
land_units_onscreen_name_Afr_Tribesmen	Tribesmen	true
land_units_onscreen_name_Ibe_Tribesmen	Iberian Tribesmen	true
land_units_onscreen_name_Ill_Tribesmen	Illyrian Tribesmen	true
land_units_onscreen_name_Ste_Tribesmen	Tribesmen	true
land_units_onscreen_name_Bri_Ambushers	Ambushers	true
land_units_onscreen_name_Mer_Pel_Rodian_Slingers	Mercenary Rodian Slingers	true
land_units_onscreen_name_3c_Cel_Chariots	Chariots	true
land_units_onscreen_name_3c_Gal_Chariots	Chariots	true
land_units_onscreen_name_Mer_Ill_Raiders	Mercenary Illyrian Raiders	true
land_units_onscreen_name_Ger_Round_Shield_Sword	Round Shield Swordsmen	true
land_units_onscreen_name_inv_iol_nuragic_runners	Nuragic Runners	true
land_units_onscreen_name_inv_etr_archers	Etruscan Archers	true
land_units_onscreen_name_inv_rom_triarii	Triarii	true
land_units_onscreen_name_Aux_Sar_Armour_Lancers	Auxiliary Armoured Lancers	true
land_units_onscreen_name_3c_Ger_Germanic_Spearmen	Germanic Spearmen	true
land_units_onscreen_name_Gre_Pike	Pikemen	true
land_units_onscreen_name_3c_Arm_Armoured_Horse_Archers	Armoured Horse Archers	true
land_units_onscreen_name_dk_kush_african_war_elephants	African War Elephants	true
land_units_onscreen_name_3c_Rom_War_Dogs	War Dogs	true
land_units_onscreen_name_3c_Ala_Armoured_Steppe_Warriors	Armoured Steppe Warriors	true
land_units_onscreen_name_3c_Mer_Armoured_Gallic_Spearmen	Mercenary Armoured Gallic Spearmen	true
land_units_onscreen_name_Ita_Mob	Mob	true
land_units_onscreen_name_3c_Aux_Thracian_Cavalry	Auxiliary Thracian Cavalry	true
land_units_onscreen_name_Mer_Syrian_Armoured_Elephants	Mercenary Syrian Armoured Elephants	true
land_units_onscreen_name_inv_ita_veteran_spearmen	Italian Veteran Spearmen	true
land_units_onscreen_name_Mer_Gre_Rhodian_Slingers	Mercenary Rhodian Slingers	true
land_units_onscreen_name_Cel_Levy_Freemen	Levy Freemen	true
land_units_onscreen_name_inv_sen_chariots	Gallic Chariots	true
land_units_onscreen_name_3c_Sas_Gyan_Avspar_comm	Gyan-Avspar Bodyguard	true
land_units_onscreen_name_dk_saba_camel_lancers	Camel Lancers	true
land_units_onscreen_name_inv_mercenary_african_cavalry	Mercenary African Cavalry	true
land_units_onscreen_name_Aux_Eas_Hillmen	Auxiliary Hillmen	true
land_units_onscreen_name_3c_Rom_Ballista_Bastion	Roman Bastion Ballista	true
land_units_onscreen_name_Aux_Bac_Hillmen	Auxiliary Bactrian Hillmen	true
land_units_onscreen_name_Mer_Pel_Kretan_Archers	Mercenary Kretan Archers	true
land_units_onscreen_name_dk_saba_desert_spearmen	Desert Spearmen	true
land_units_onscreen_name_3c_Mer_Highland_Archers	Mercenary Highland Archers	true
land_units_onscreen_name_3c_Aux_Illyrian_Slingers	Auxiliary Illyrian Slingers	true
land_units_onscreen_name_3c_Ger_Germanic_Pikes	Germanic Pikes	true
land_units_onscreen_name_Mer_Ibe_Slingers	Mercenary Iberian Slingers	true
land_units_onscreen_name_Afr_Elephants	African Elephants	true
land_units_onscreen_name_3c_Eas_Eastern_Infantry	Eastern Infantry	true
land_units_onscreen_name_Mer_Ind_War_Elephants	Mercenary Indian War Elephants	true
land_units_onscreen_name_Mer_Ger_Spear_Brothers	Mercenary Spear Brothers	true
land_units_onscreen_name_inv_mercenary_gallic_horsemen	Mercenary Gallic Horsemen	true
land_units_onscreen_name_3c_Ger_Germanic_Lancers	Germanic Lancers	true
land_units_onscreen_name_3c_Sas_Eastern_Scouts	Eastern Scouts	true
land_units_onscreen_name_inv_sardi_bowmen	Native Sardi Bowmen	true
land_units_onscreen_name_Eas_Ballista_Shp	Eastern Ballista (Ship)	true
land_units_onscreen_name_Dac_Bow_Horsemen	Bow Horsemen	true
land_units_onscreen_name_3c_Aux_Horse_Skirmishers	Auxiliary Horse Skirmishers	true
land_units_onscreen_name_inv_rom_ballista	Roman Ballista	true
land_units_onscreen_name_inv_sam_ballista	Samnite Ballista	true
land_units_onscreen_name_3c_Mer_Horse_Skirmishers	Mercenary Horse Skirmishers	true
land_units_onscreen_name_3c_Arm_Azat_Knights_comm	Azat Knights Bodyguard	true
land_units_onscreen_name_3c_Ara_Arabian_Slingers	Arabian Slingers	true
land_units_onscreen_name_3c_Per_Persian_Armoured_Cavalry	Persian Armoured Cavalry	true
land_units_onscreen_name_Rom_Principes	Principes	true
land_units_onscreen_name_3c_Eas_Eastern_Armoured_Cavalry	Eastern Armoured Cavalry	true
land_units_onscreen_name_dk_kush_royal_kushite_archers	Royal Kushite Archers	true
land_units_onscreen_name_Afr_Numidian_Noble_Cav	Numidian Noble Cavalry	true
land_units_onscreen_name_3c_Per_Persian_Slingers	Persian Slingers	true
land_units_onscreen_name_3c_Eas_Eastern_Slingers	Eastern Slingers	true
land_units_onscreen_name_inv_ita_italic_slingers	Italian Slingers	true
land_units_onscreen_name_3c_Marc_Longbow_Hunters	Longbow Hunters	true
land_units_onscreen_name_dk_nab_nabatean_noble_cavalry	Nabataean Noble Cavalry	true
land_units_onscreen_name_3c_Aux_Illyrian_Archers	Auxiliary Illyrian Archers	true
land_units_onscreen_name_3c_Goth_Gothic_Brigands	Gothic Brigands	true
land_units_onscreen_name_3c_Rom_Ballista	Roman Ballista	true
land_units_onscreen_name_Mer_Sar_Armour_Lancers	Mercenary Armoured Lancers	true
land_units_onscreen_name_inv_sam_italian_hillmen	Italian Hillmen	true
land_units_onscreen_name_inv_gre_toxotes	Toxotes	true
land_units_onscreen_name_3c_Mer_Eastern_Cataphracts	Mercenary Eastern Cataphracts	true
land_units_onscreen_name_Afr_Ballista_Shp	African Ballista (Ship)	true
land_units_onscreen_name_Car_Ballista_Shp	Carthaginian Ballista (Ship)	true
land_units_onscreen_name_Ger_Ballista_Shp	German Ballista (Ship)	true
land_units_onscreen_name_3c_Aux_Bactrian_Light_Cavalry	Auxiliary Bactrian Light Cavalry	true
land_units_onscreen_name_Mer_Gre_Hoplites	Mercenary Hoplites	true
land_units_onscreen_name_inv_iol_ballista	Iolean Ballista	true
land_units_onscreen_name_3c_Ger_Armoured_Germanic_Swordsmen	Armoured Germanic Swords	true
land_units_onscreen_name_3c_Mer_Armoured_Germanic_Swordsmen	Mercenary Armoured Germanic Swordsmen	true
land_units_onscreen_name_inv_mercenary_nuragic_runners	Mercenary Nuragic Runners	true
land_units_onscreen_name_3c_Pal_Peltasts	Peltasts	true
land_units_onscreen_name_Aux_Ger_Longbow_Hunters	Auxiliary Longbow Hunters	true
land_units_onscreen_name_inv_mercenary_veneti_horsemen	Mercenary Veneti Horsemen	true
land_units_onscreen_name_3c_Aux_Armenian_Archers	Auxiliary Armenian Archers	true
land_units_onscreen_name_Ger_Hex_Bearers	Hex-Bearers	true
land_units_onscreen_name_Mer_Sar_Lancers	Mercenary Sarmatian Lancers	true
land_units_onscreen_name_Gre_Spartan_Pike	Spartan Pikemen	true
land_units_onscreen_name_Aux_Ibe_Scutarii	Auxiliary Scutarii	true
land_units_onscreen_name_Bri_Painted_Ones	Painted Ones	true
land_units_onscreen_name_Aux_Afr_Elephant	Auxiliary African Elephants	true
land_units_onscreen_name_3c_Rom_Equites_Scutarii	Equites Scutarii	true
land_units_onscreen_name_3c_Goth_Greuthungi_Lancers_comm	Greuthungi Lancers Bodyguard	true
land_units_onscreen_name_inv_sar_corsic_marksmen	Corsican Marksmen	true
land_units_onscreen_name_Gre_Light_Cav	Light Cavalry	true
land_units_onscreen_name_3c_Aux_Arabian_Spearmen	Auxiliary Arabian Spearmen	true
land_units_onscreen_name_inv_rom_hastati	Hastati	true
land_units_onscreen_name_Aux_Cav	Auxiliary Cavalry	true
land_units_onscreen_name_3c_Aux_Scutarii_Cavalry	Auxiliary Scutarii Cavalry	true
land_units_onscreen_name_Gre_Royal_Thorax_Sword	Royal Thorax Swordsmen	true
land_units_onscreen_name_inv_mercenary_gallic_axe_cavalry	Mercenary Gallic Axe Cavalry	true
land_units_onscreen_name_Mer_Egy_Leopard_Warriors	Mercenary Leopard Warriors	true
land_units_onscreen_name_Mer_Bri_Slingers	Mercenary Briton Slingers	true
land_units_onscreen_name_Mer_Thr_Warriors	Mercenary Thracian Warriors	true
land_units_onscreen_name_inv_mercenary_italian_hillmen	Mercenary Italian Hillmen	true
land_units_onscreen_name_Aux_Ger_Spear_Brothers	Auxiliary Spear Brothers	true
land_units_onscreen_name_Mer_Ibe_Noble_Fighters	Mercenary Noble Fighters	true
land_units_onscreen_name_Cel_Galatian_Noblemen	Galatian Noblemen	true
land_units_onscreen_name_Ita_Cav	Italian Cavalry	true
land_units_onscreen_name_Mer_Eas_Syrian_Archers	Mercenary Syrian Archers	true
land_units_onscreen_name_3c_Eas_Eastern_Cataphracts_comm	Eastern Cataphracts Bodyguard	true
land_units_onscreen_name_3c_Aux_Bactrian_Hillmen	Auxiliary Bactrian Hillmen	true
land_units_onscreen_name_3c_Per_Persian_Cataphracts_comm	Persian Cataphracts Bodyguard	true
land_units_onscreen_name_3c_Rom_Slingers	Slingers	true
land_units_onscreen_name_3c_Arm_Armoured_Armenian_Archers	Armoured Armenian Archers	true
land_units_onscreen_name_Aux_Gre_Rhodian_Slingers	Auxiliary Rhodian Slingers	true
land_units_onscreen_name_3c_Goth_Greuthungi_Noble_Cavalry	Greuthungi Noble Cavalry	true
land_units_onscreen_name_3c_Cal_Ambushers	Ambushers	true
land_units_onscreen_name_3c_Arm_Persian_Spearmen	Persian Spearmen	true
land_units_onscreen_name_dk_saba_merc_maas_gat_marauders	Mercenary Maas Gat Marauders	true
land_units_onscreen_name_Mer_Gre_Molossian_Dogs	Mercenary Molossian Dogs	true
land_units_onscreen_name_Ibe_Lusitani_Guerillas	Lusitani Guerrillas	true
land_units_onscreen_name_Gre_Scythian_Hoplites	Scythian Hoplites	true
land_units_onscreen_name_dk_kush_disciples_of_apedemak	Disciples of Apedemak	true
land_units_onscreen_name_inv_lucanian_warriors	Native Lucanian Warriors	true
land_units_onscreen_name_3c_Bri_Ballista	Briton Ballista	true
land_units_onscreen_name_3c_Pal_Imperial_Pikemen	Imperial Pikemen	true
land_units_onscreen_name_Aux_Egy_Archers	Auxiliary Egyptian Archers	true
land_units_onscreen_name_dk_num_armoured_numidian_riders	Armoured Numidian Riders	true
land_units_onscreen_name_inv_iol_sherden_horsemen	Sherden Horsemen	true
land_units_onscreen_name_3c_Rom_Herculianii	Herculianii	true
land_units_onscreen_name_3c_Eas_Eastern_Cataphracts	Eastern Cataphracts	true
land_units_onscreen_name_3c_Mer_Syrian_Armoured_Elephants	Mercenary Syrian Armoured Elephants	true
land_units_onscreen_name_Aux_Ibe_Slingers	Auxiliary Iberian Slingers	true
land_units_onscreen_name_inv_gre_hoplites	Hoplites	true
land_units_onscreen_name_Pel_Thr_Peltasts	Thraike Peltasts	true
land_units_onscreen_name_3c_Aux_Scythed_Chariots	Auxiliary Scythed Chariots	true
land_units_onscreen_name_Ita_Etruscan_Hoplites	Etruscan Hoplites	true
land_units_onscreen_name_Ara_Cav	Arabian Cavalry	true
land_units_onscreen_name_Aux_Afr_Archers	Auxiliary Sabaean Archers	true
land_units_onscreen_name_3c_Aux_Persian_Cataphracts	Auxiliary Persian Cataphracts	true
land_units_onscreen_name_3c_Sab_Sabean_Cavalry_comm	Sabean Cavalry Bodyguard	true
land_units_onscreen_name_3c_Aux_Thracian_Light_Cavalry	Auxiliary Thracian Light Cavalry	true
land_units_onscreen_name_Aux_Gre_Peltasts	Auxiliary Peltasts	true
land_units_onscreen_name_3c_Ala_Alani_Axe_Cavalry	Alani Axe Cavalry	true
land_units_onscreen_name_Car_African_Pike	African Pikemen	true
land_units_onscreen_name_Mer_Dac_Spear_Horsemen	Mercenary Spear Horsemen	true
land_units_onscreen_name_inv_mercenary_hippeus	Mercenary Hippeus	true
land_units_onscreen_name_Car_Noble_Cav	Noble Cavalry	true
land_units_onscreen_name_Ibe_Noble_Cav	Noble Cavalry	true
land_units_onscreen_name_Ita_Noble_Cav	Italian Noble Cavalry	true
land_units_onscreen_name_inv_ven_veneti_horsemen	Veneti Horsemen	true
land_units_onscreen_name_inv_ligurian_swordsmen	Native Ligurian Swordsmen	true
land_units_onscreen_name_inv_mercenary_volsci_veterans	Mercenary Volsci Veterans	true
land_units_onscreen_name_3c_Ste_Ballista_Bastion	Steppe Bastion Ballista	true
land_units_onscreen_name_Aux_Per_Archers	Auxiliary Persian Archers	true
land_units_onscreen_name_Aux_Dac_Falxmen	Auxiliary Falxmen	true
land_units_onscreen_name_3c_Eas_Scorpion	Eastern Scorpion (Fixed)	true
land_units_onscreen_name_3c_Rom_Beehive_Onager	Roman Beehive Onager	true
land_units_onscreen_name_inv_etr_etruscan_cavalry	Etruscan Cavalry	true
land_units_onscreen_name_Gre_Agema_Cav	Agema Cavalry	true
land_units_onscreen_name_3c_Aux_Armoured_Gallic_Spearmen	Auxiliary Armoured Gallic Spearmen	true
land_units_onscreen_name_Ger_Riders_Hunt	Riders of the Hunt	true
land_units_onscreen_name_3c_Rom_Jovianii	Jovianii	true
land_units_onscreen_name_inv_ill_raiders	Illyrian Raiders	true
land_units_onscreen_name_3c_Num_Numidian_Cavalry	Numidian Cavalry	true
land_units_onscreen_name_inv_ligurian_horsemen	Native Ligurian Horsemen	true
land_units_onscreen_name_Aux_Eas_Cappadocian_Cav	Auxiliary Cappadocian Cavalry	true
land_units_onscreen_name_inv_rom_accensi	Accensi	true
land_units_onscreen_name_3c_Afr_Scorpion	African Scorpion (Fixed)	true
